y, aunque; también; incluso	conjunción		и
en, a, hacia	preposición		в
no, sin	adverbio		не
en, a, hacia	preposición		на
yo	pronombre		я
que	conjunción, determinante, pronombre		что
ser, estar	verbo		быть
con, y (+ instrumental), desde, de (+ genitivo)	preposición		с
él	pronombre		он
y, pero	conjunción		а
esto/a, eso/a	determinante, pronombre		это
como, cómo, cuando, desde	conjunción		как
algún; justo; entonces	partícula		то
este	pronombre		этот
en, a lo largo de, por	preposición		по
a, hacia, por	preposición		к
pero, sin embargo	conjunción		но
ellos/as	pronombre		они
nosotros/as	pronombre		мы
ella	pronombre		она
el cual, (el) que	pronombre		который
de, desde, por	preposición		из
en, con	preposición		у
su propio	pronombre		свой
usted/es, vosotros	pronombre		вы
completo, entero, todo	pronombre		весь
tras, detrás de, por	preposición		за
para	preposición		для
de, desde, a causa de	preposición		от
sobre (+ preposicional), contra (+ acusativo), masterrussian dot com	preposición		о
así, de tal manera, tanto, entonces	adverbio, conjunción		так
poder, ser capaz de	verbo		мочь
todos, todo el mundo	pronombre		все
tú	pronombre		ты
y, pero, mientras, pues	partícula		же
año	nombre		год
hombre, persona, ser humano	nombre		человек
un, uno, sólo	número, pronombre		один
tan	pronombre		такой
ese, aquel	pronombre		тот
o	conjunción		или
si	conjunción		если
solo, apenas, pero	partícula		только
su (de él), lo (acusativo)	pronombre		его
expresa modo condicional (p. ej. хотел бы = querría)	partícula		бы
a sí mismo	pronombre		себя
tiempo, estación, edad, tiempo (gramatical)	nombre		время
cuando, mientras	conjunción		когда
aún, todavía, incluso	partícula		ещё
ya	adverbio		уже
otro, diferente	pronombre		другой
decir, contar	verbo		сказать
hasta, antes	preposición		до
mi	pronombre		мой
nuestro	pronombre		наш
para	conjunción		чтобы
hablar, decir	verbo		говорить
mismo, el mismísimo, el más	pronombre		самый
saber	verbo		знать
aquí está, toma	partícula		вот
muy, mucho	adverbio		очень
no; no hay	partícula		нет
quien, quién, el/la que, alguien	pronombre		кто
cerca, en presencia de, con	preposición		при
sí; y, pero	exclamación		да
día, tarde	nombre		день
primero, primer	número		первый
incluso	partícula		даже
se puede, está permitido	adverbio		можно
vida	nombre		жизнь
ni	conjunción		ни
uno sólo, uno mismo, por sí mismo	pronombre		сам
hecho, negocio, asunto, caso	nombre		дело
dos, pareja	número		два
nuevo	adjetivo		новый
vez, una vez	nombre		раз
querer, desear	verbo		хотеть
tener que, deber	adverbio		должен
si	conjunción		ли
cuál, qué	pronombre		какой
con (variación de "c") masterrussian	preposición		со
allí, allá, ahí	adverbio, pronombre		там
su (de ellos), los (acusativo)	pronombre		их
mucho, muchos	adverbio		много
trabajo	nombre		работа
tener, poseer	verbo		иметь
después, tras	adverbio		после
donde, dónde	adverbio		где
pregunta, questión, tema	nombre		вопрос
mano, brazo; masterrussian dot com	nombre		рука
ciudad, pueblo	nombre		город
su (de ella), la (acusativo)	pronombre		её
bajo, debajo	preposición		под
cada, cada uno	pronombre		каждый
palabra	nombre		слово
lugar, sitio, puesto	nombre		место
sin	preposición		без
pues, venga	partícula		ну
niño	nombre		ребёнок
simplemente, tan solo	adverbio		просто
más	adverbio		более
amigo	nombre		друг
gran, grande	adjetivo		большой
hace falta, es necesario, hay que	adverbio		надо
que, en lugar de, que (instrumental de "что")	conjunción		чем
vuestro, su (de usted)	pronombre		ваш
hacer	verbo		сделать
ir, suceder	verbo		идти
aquí	adverbio		здесь
hacer	verbo		делать
ahora, en este momento	adverbio		сейчас
Rusia	nombre propio		Россия
ver	verbo		видеть
luego, después	adverbio		потом
nada	pronombre		ничто
dentro de, en, por, a lo largo de, masterrussian dot com, con ayuda de	preposición		через
paz; universo, mundo	nombre		мир
ahora, hoy	adverbio		теперь
algunos, unos pocos	adverbio		несколько
pensar	verbo		думать
caso, hecho, situación	nombre		случай
lado, dirección, parte	nombre		сторона
buen, bueno; guapo	adjetivo		хороший
también	adverbio, conjunción		тоже
ojo	nombre		глаз
entonces	adverbio		тогда
aquí; ahora	adverbio		тут
casa, hogar, edificio	nombre		дом
país	nombre		страна
sobre (+ preposicional), contra (+ acusativo)	preposición		об
fuerza, poder	nombre		сила
último	adjetivo		последний
trabajar, manipular	verbo		работать
también, además	adverbio		также
cara, rostro; persona	nombre		лицо
vivir	verbo		жить
parte, pieza, porción	nombre		часть
aunque	conjunción		хотя
mujer	nombre		женщина
sistema	nombre		система
siempre	adverbio		всегда
aparecer	verbo		являться
vista, aspecto, apariencia	nombre		вид
cabeza, mente, masterrussian.com	nombre		голова
problema	nombre		проблема
final, extremo, punta, fin	nombre		конец
es que, ya que; si; en efecto	partícula		ведь
entre	preposición		между
por supuesto	adverbio		конечно
mirar, ver, observar	verbo		смотреть
hasta luego; por el momento, mientras	adverbio		пока
relación; tratamiento	nombre		отношение
ruso	adjetivo		русский
tres	número		три
segundo	número		второй
exactamente, precisamente, justo, eso	partícula		именно
frente, en frente de, ante	preposición		перед
sólo; en cuanto	partícula		лишь
forma, imagen	nombre		образ
dinero	nombre		деньги
por eso, por lo tanto, de ahí que	conjunción		поэтому
por qué	adverbio		почему
entender, comprender, darse cuenta	verbo		понимать
Moscú	nombre propio		Москва
cualquiera, cada	pronombre		любой
sin embargo, pero	conjunción		однако
bien, vale	adverbio		хорошо
nadie	pronombre		никто
hora, en punto	nombre		час
contar, pensar, creer	verbo		считать
tomar, coger, agarrar	verbo		взять
sobre	preposición		над
tierra	nombre		земля
hoy	adverbio		сегодня
en general	adverbio		вообще
libro	nombre		книга
ir	verbo		пойти
posibilidad, oportunidad	nombre		возможность
algún	pronombre		некоторый
compañía, empresa	nombre		компания
historia	nombre		история
querer, amar, gustar	verbo		любить
alto	adjetivo		высокий
necesario, hay que	adverbio		нужно
casi	adverbio		почти
tu, tuyo	pronombre		твой
resultado	nombre		результат
más	adverbio		больше
por ejemplo	adverbio		например
derecho; licencia/permiso (cuando se usa en plural) masterrussian dot com	nombre		право
grupo	nombre		группа
escribir	verbo		писать
estar sentado, sentar	verbo		сидеть
camino, ruta, forma	nombre		путь
auto, coche, maquína	nombre		машина
algo	pronombre		что-то
estar situado, encontrase, localizarse	verbo		находиться
ver, notar	verbo		увидеть
guerra	nombre		война
parecer, tener apariencia	verbo		казаться
estar de pie; pararse	verbo		стоять
nombre; reputación	nombre		имя
nunca	adverbio		никогда
costar; merecer la pena	verbo		стоить
pequeño	adjetivo		маленький
respuesta	nombre		ответ
agua; refresco	nombre		вода
decisión	nombre		решение
dios; Dios	nombre		бог
completamente, totalmente	adverbio		совсем
idioma, lengua	nombre		язык
lejos, alejado	adverbio		далеко
necesario; útil	adjetivo		нужный
dar; permitir	verbo		давать
completo; lleno	adjetivo		полный
de Rusia	adjetivo		российский
gente, pueblo, nación	nombre		народ
poder	nombre		власть
inmediatamente, ahora mismo	adverbio		сразу
nivel	nombre		уровень
noche	nombre		ночь
es hora de	adverbio		пора
a menudo	adverbio		часто
desarrollo	nombre		развитие
programa	nombre		программа
comienzo, principio	nombre		начало
ninguno	pronombre		никакой
ello	pronombre		оно
principal	adjetivo		главный
puerta	nombre		дверь
juntos	adverbio		вместе
momento, instante	nombre		момент
ley	nombre		закон
número; fecha, día	nombre		число
objetivo, propósito	nombre		цель
siguiente, próximo	adjetivo		следующий
escribir	verbo		написать
padre	nombre		отец
verdad, certeza	nombre		правда
pie, pierna	nombre		нога
viejo, anciano	adjetivo		старый
ayuda, asistencia	nombre		помощь
información	nombre		информация
ya (forma abreviada de "уже́")	adverbio		уж
mil	número		тысяча
similar, parecido	adjetivo		подобный
diferente, diverso	adjetivo		разный
general, común	adjetivo		общий
mes; luna en cuarto creciente/menguante	nombre		месяц
excepto, aparte de	preposición		кроме
minuto; momento	nombre		минута
poco	adverbio		мало
proceso	nombre		процесс
situación	nombre		ситуация
poder, ser capaz de (aspecto perfectivo de "мочь") masterrussian dot com	verbo		смочь
autor	nombre		автор
empezar, comenzar	verbo		начинать
forma; uniforme (prenda)	nombre		форма
voz; voto	nombre		голос
propio, personal	adjetivo		собственный
idea, pensamiento	nombre		мысль
luz, electricidad; mundo, la Tierra	nombre		свет
calidad	nombre		качество
escuela	nombre		школа
cualquiera, cada	pronombre		всякий
acción; efecto	nombre		действие
hombre	nombre		мужчина
oblast, provincia, región	nombre		область
atención	nombre		внимание
seguir; tener que, deber	verbo		следовать
usar, utilizar	verbo		использовать
camino, ruta, carretera; viaje	nombre		дорога
conexión, lazo, relación	nombre		связь
mirada, vista; opinión	nombre		взгляд
condición, término; masterrussian.com	nombre		условие
joven	adjetivo		молодой
rápido, veloz; pronto	adverbio		скоро
de nuevo, otra vez	adverbio		снова
amor	nombre		любовь
principal, fundamental, primario	adjetivo		основной
ponerse; convertirse	verbo		становиться
importante	adjetivo		важный
esperar	verbo		ждать
de repente	adverbio		вдруг
juego	nombre		игра
leer	verbo		читать
artículo; cláusula	nombre		статья
organización, entidad	nombre		организация
medios; remedio	nombre		средство
existir, ser	verbo		существовать
alma, espíritu	nombre		душа
intentar, tratar	verbo		пытаться
cuerpo, figura	nombre		тело
mirar, ver, observar	verbo		посмотреть
sociedad	nombre		общество
mujer, esposa	nombre		жена
estado, gobierno	nombre		государство
quedarse	verbo		оставаться
perfectamente, absolutamente	adverbio		совершенно
carta	nombre		письмо
condición, estado; fortuna, riqueza	nombre		состояние
tarde, noche; fiesta	nombre		вечер
verdadero, auténtico, real	adjetivo		настоящий
atrás, hacia atrás	adverbio		назад
sentido, significado	nombre		смысл
medida	nombre		мера
familia	nombre		семья
simple, sencillo, común	adjetivo		простой
cosa; cosas, pertenencias (si se usa en plural)	nombre		вещь
después, luego	adverbio		затем
causa, razón, motivo	nombre		причина
mañana (parte del día)	nombre		утро
madre	nombre		мать
mercado	nombre		рынок
de verdad, en realidad	adverbio		действительно
ocurrir, pasar, tener lugar; ser de	verbo		происходить
dado, este	adjetivo		данный
chica, una joven; novia	nombre		девушка
guiar; portarse, comportarse; conducir, manejar	verbo		вести
cuánto	adverbio		сколько
tema	nombre		тема
mesa	nombre		стол
proyecto; plano	nombre		проект
calle, carretera	nombre		улица
estatal, nacional	adjetivo		государственный
recordar, tener presente	verbo		помнить
llamar, poner nombre	verbo		называть
punto	nombre		точка
querer	verbo		хотеться
no se puede, está prohibido	adverbio		нельзя
blanco	adjetivo		белый
centro	nombre		центр
otra vez, de nuevo	adverbio		опять
igual	adjetivo		равный
contra	adverbio		против
hacia donde, hacia dónde	adverbio		куда
semana	nombre		неделя
idea, concepto	nombre		идея
especialmente, en particular	adverbio		особенно
habitación, cuerto, estancia	nombre		комната
precio	nombre		цена
por fin, finalmente	adverbio		наконец
conocido, famoso	adjetivo		известный
entre	preposición		среди
hijo	nombre		сын
actividad, trabajo	nombre		деятельность
jugar; tocar (música)	verbo		играть
regla, regulación	nombre		правило
soviético	adjetivo		советский
el mejor	adjetivo		лучший
movimiento; tráfico	nombre		движение
practicar; estar ocupado con, ocuparse de; masterrussian.com	verbo		заниматься
justo, exactamente	partícula		точно
enorme, gigante	adjetivo		огромный
mamá	nombre		мама
tarea, misión, objetivo	nombre		задача
gran	adjetivo		великий
cantidad	nombre		количество
sentimiento; sentido (sensorial)	nombre		чувство
a veces	adverbio		иногда
demasiado, excesivamente	adverbio		слишком
muerte	nombre		смерть
suficiente, bastante	adverbio, determinante, pronombre		достаточно
estar tumbado, yacer; estar situado	verbo		лежать
opinión	nombre		мнение
trabajo, labor	nombre		труд
cinco	número		пять
tercero	número		третий
suceder, ocurrir; estar en, visitar	verbo		бывать
listo, preparado	adjetivo		готовый
rápido, veloz	adverbio		быстро
negro	adjetivo		чёрный
fuerte, poderoso, intenso	adjetivo		сильный
orden, secuencia	nombre		порядок
sentir	verbo		чувствовать
ejemplo	nombre		пример
condición, estado; posición, localización; masterrussian dot com	nombre		положение
siglo; edad, época	nombre		век
continuar, seguir	verbo		продолжать
pensar, considerar	verbo		подумать
marido, hombre	nombre		муж
ya que, como; en vista que	conjunción		поскольку
militar	nombre		военный
el habla, discurso	nombre		речь
plan	nombre		план
consejo	nombre		совет
político	adjetivo		политический
muro, pared	nombre		стена
presentar; imaginar	verbo		представлять
oir	verbo		слышать
ir, caminar, andar; acudir	verbo		ходить
ventana	nombre		окно
junto, cerca	adverbio		рядом
antes, anteriormente	adverbio		прежде
experiencia; experimento	nombre		опыт
tipo, modelo	nombre		тип
ambos	determinante, pronombre		оба
cerca, alrededor	preposición		около
contestar, responder; estar al cargo de; cumplir (requisitos)	verbo		отвечать
interés	nombre		интерес
contemporaneo, moderno, actual	adjetivo		современный
malo	adjetivo		плохой
desde atrás; por culpa de	preposición		из-за
corazón	nombre		сердце
control, dirección, gestión	nombre		управление
datos, información	nombre		данные
ciencia	nombre		наука
mensaje	nombre		сообщение
pedir, solicitar	verbo		просить
un poco	adverbio		немного
periódico, diario	nombre		газета
interesante	adjetivo		интересный
vivo	adjetivo		живой
poner, colocar	verbo		поставить
necesario	adjetivo		необходимый
material	nombre		материал
rol, papel	nombre		роль
bastante, completamente	adverbio, determinante		вполне
como si	partícula		будто
salir, dejar; ser publicado	verbo		выходить
temprano	adverbio		рано
recibir, obtener	verbo		получать
hace mucho	adverbio		давно
ejército	nombre		армия
trabajador, obrero	nombre		рабочий
cuatro	número		четыре
tener miedo de, temer	verbo		бояться
diverso, diferente, masterrussian dot com	adjetivo		различный
por mucho tiempo, durante mucho tiempo	adverbio		долго
traer, llevar a; citar	verbo		привести
presidente, director	nombre		президент
o	conjunción		либо
menos	adverbio		менее
evento, incidente, hecho	nombre		событие
rojo	adjetivo		красный
social	adjetivo		социальный
buscar	verbo		искать
mayoría	nombre		большинство
negocio	nombre		бизнес
que (+subjuntivo. Por ej. "que entre, que lo diga")	partícula		пусть
fácilmente	adverbio		легко
gobierno	nombre		правительство
directo, recto; franco, sincero	partícula		прямо
jefe, cabeza; capítulo	nombre		глава
miembro	nombre		член
juzgado	nombre		суд
posiblemente, probablemente, tal vez; tan… como sea posible	adverbio		возможно
aceptar, admitir, tomar	verbo		принимать
rublo	nombre		рубль
millón	número		миллион
entero, completo; intacto	adjetivo		целый
llegar	verbo		приходить
película	nombre		фильм
normalmente	adverbio		обычно
cuenta, factura	nombre		счёт
dormir	verbo		спать
pequeño, bajo	adjetivo		небольшой
cultura	nombre		культура
texto; letra (música)	nombre		текст
tomar, coger, agarrar	verbo		брать
documento, papel	nombre		документ
principio	nombre		принцип
conversación	nombre		разговор
teléfono; número de teléfono	nombre		телефон
derecho	adjetivo		правый
método, modo, forma	nombre		способ
corriente (río), curso, marcha	nombre		течение
llevar, acompañar; pasar	verbo		провести
suelo; sexo, género	nombre		пол
alrededor	adverbio		вокруг
pasar, suceder, acontecer	verbo		проходить
comprar	verbo		купить
padre (o madre)	nombre		родитель
fila, hilera	nombre		ряд
único	adjetivo		единственный
metro	nombre		метр
sitio web	nombre		сайт
partido político; lote	nombre		партия
permitir	verbo		позволять
educación	nombre		образование
para qué, por qué	adverbio		зачем
probablemente, seguramente	adverbio		наверное
periodo	nombre		период
por cierto; oportunamente	adverbio		кстати
pareja, par	nombre		пара
piso, apartamento	nombre		квартира
significado, sentido	nombre		значение
interno	adjetivo		внутренний
pedir, demandar, requerir	verbo		требовать
más allá, después, más adelante	adverbio		далее
base, fundamento, masterrussian.com	nombre		основа
posible, probable, potencial	adjetivo		возможный
deseo	nombre		желание
escuchar, atender	verbo		слушать
casi, apenas	adverbio		чуть
número; habitación (hotel); talla	nombre		номер
cambio, modificación	nombre		изменение
cola, turno	nombre		очередь
política	nombre		политика
clase, grado	nombre		класс
hecho	nombre		факт
hermano	nombre		брат
prepararse; recoger; ir a	verbo		собираться
cierto, preciso, específico	adjetivo		определённый
bastante	adverbio		довольно
producción, manufactura	nombre		производство
creación; criatura	nombre		создание
área, región	nombre		район
especial	adjetivo		особый
creer, confiar	verbo		верить
gracias	exclamación		спасибо
empresa, compañía, negocio	nombre		предприятие
cerca, cercano, íntimo	adjetivo		близкий
movimiento, paso	nombre		ход
económico	adjetivo		экономический
familiar, conocido	adjetivo		знакомый
humano	adjetivo		человеческий
local, regional, del país	adjetivo		местный
cielo	nombre		небо
dirección, tendencia	nombre		направление
allí, hacia allí	adverbio		туда
encuentro, reunión	nombre		встреча
paso	nombre		шаг
demás, restante	pronombre		остальной
equipo; orden	nombre		команда
bueno, bondadoso	adjetivo		добрый
campo	nombre		поле
EEUU (Estados Unidos)	nombre propio		США
estudio, investigación	nombre		исследование
público, social	adjetivo		общественный
chico	nombre		мальчик
método, modo, forma, técnica	nombre		метод
excusa, razón	nombre		повод
crecimiento, altura, masterrussian.com	nombre		рост
primero, primeramente, en primer lugar	adverbio		сначала
contar, narrar	verbo		рассказывать
sueño	nombre		сон
irse, largarse	verbo		уходить
servicio, trabajo	nombre		служба
población	nombre		население
aire	nombre		воздух
como si	partícula		словно
sangre	nombre		кровь
preguntar, pedir	verbo		спрашивать
vista, sentido de la vista	nombre		зрение
médico, doctor	nombre		врач
viajar, ir (en un vehículo)	verbo		ехать
gustar	verbo		нравиться
tener que; ser	verbo		приходиться
conocimiento, saber	nombre		знание
sin embargo	partícula		всё-таки
uso, utilización	nombre		использование
algún; un tipo de	pronombre		какой-то
diez	número		десять
dedo	nombre		палец
corriente, normal, común	adjetivo		обычный
necesario, hay que	adverbio		необходимо
órgano	nombre		орган
dólar	nombre		доллар
sujetar; guardar, almacenar	verbo		держать
nombre, título	nombre		название
similar, parecido	adjetivo		похожий
caro, valioso	adjetivo		дорогой
real, tangible, auténtico	adjetivo		реальный
participación	nombre		участие
familia, clan, generación	nombre		род
el más; sobre todo	adverbio		наиболее
chica, chiquilla	nombre		девочка
grande	adjetivo		крупный
mar	nombre		море
de algún modo	adverbio		как-то
naturaleza	nombre		природа
tienda	nombre		магазин
parece, de algún modo	partícula		вроде
memoria	nombre		память
bastante, muy	adverbio		весьма
más grande	adjetivo		больший
a casa, en dirección a casa	adverbio		домой
objeto	nombre		объект
libertad	nombre		свобода
producto; alimento	nombre		продукт
pelea, lucha	nombre		борьба
personal, individual, privado, propio	adjetivo		личный
concerner, importar, tocar, masterrussian dot com, tener que ver	verbo		касаться
separado, individual, aislado	adjetivo		отдельный
objeto, tema, materia	nombre		предмет
representante	nombre		представитель
hombro	nombre		плечо
nacional	adjetivo		национальный
música	nombre		музыка
avión	nombre		самолёт
posición, actitud	nombre		позиция
americano	adjetivo		американский
intentar, tratar	verbo		стараться
héroe	nombre		герой
carácter, personalidad, temperamento	nombre		характер
talla, escala	nombre		размер
beber	verbo		пить
medio, en la media	adjetivo		средний
plazo, lapso, duración, periodo	nombre		срок
instituto, institución; universidad	nombre		институт
red; sistema; circuito	nombre		сеть
sol, el Sol	nombre		солнце
serio	adjetivo		серьёзный
si no, de otro modo	adverbio		иначе
enseñar, mostrar	verbo		показывать
unión, alianza, conjunción	nombre		союз
espíritu	nombre		дух
Internet	nombre propio		Интернет
bosque	nombre		лес
revista	nombre		журнал
grado, extensión; potencia (metemáticas)	nombre		степень
ofrecer, proponer, sugerir	verbo		предлагать
territorio	nombre		территория
marzo	nombre		март
éxito, suerte, avance	nombre		успех
arte; artesanía	nombre		искусство
participante, jugador (deportes)	nombre		участник
chico, novio	nombre		парень
libre	adjetivo		свободный
invitado, visitante	nombre		гость
sin embargo	adverbio		впрочем
variante, versión, opción	nombre		вариант
proposición, oferta, sugerencia; frase, oración; oferta (economía)	nombre		предложение
destino, fortuna	nombre		судьба
componer, juntar, unir, preparar	verbo		составлять
producto; stock, mercancía	nombre		товар
esperar, tener la esperanza	verbo		надеяться
actuar, obrar; ser válido, estar en vigor	verbo		действовать
internacional	adjetivo		международный
capaz (de)	adjetivo		способный
practicamente, virtualmente	adverbio		практически
director	nombre		директор
Europa	nombre propio		Европа
totalmente, completamente	adverbio		полностью
avanzado, tardío	adjetivo		поздний
canción	nombre		песня
mejor; preferiblemente	adjetivo		лучше
mente, inteligencia	nombre		ум
opción, elección	nombre		выбор
alguien	pronombre		кто-то
modelo; diseño, prototipo	nombre		модель
río	nombre		река
empresa, compañía	nombre		фирма
ciudadano	nombre		гражданин
camarada, amigo	nombre		товарищ
normal, común	adjetivo		нормальный
conciencia, percepción	nombre		сознание
cuadro, pintura; película	nombre		картина
fuertemente, con fuerza	adverbio		сильно
abril	nombre		апрель
origen; fuente (de agua)	nombre		источник
en lugar de	preposición		вместо
frontera	nombre		граница
consistir, estar compuesto	verbo		состоять
en total; sólo	partícula		всего
mitad	nombre		половина
operación, transacción	nombre		операция
estimación, evaluación; nota (académica)	nombre		оценка
fuego	nombre		огонь
constantemente, continuamente, todo el tiempo; master russian com	adverbio		постоянно
especialista, experto	nombre		специалист
lo más importante	nombre		главное
perro	nombre		собака
ordenador, computadora	nombre		компьютер
guapo, hermoso, bonito	adjetivo		красивый
tecnología	nombre		технология
árbol; madera	nombre		дерево
salida	nombre		выход
monte, montaña	nombre		гора
entrar	verbo		входить
mundial, global	adjetivo		мировой
científico	adjetivo		научный
ser capaz; saber	verbo		уметь
infantil	adjetivo		детский
barco	nombre		корабль
desear	verbo		желать
orilla, rivera, costa, margen	nombre		берег
ancho	adjetivo		широкий
bajo, corto; inferior (calidad); masterrussian dot com; grave (voz)	adjetivo		низкий
maravilloso	adjetivo		прекрасный
futuro	nombre		будущее
exterior	adjetivo		внешний
literatura	nombre		литература
pesado; difícil	adjetivo		тяжелый
empleado, trabajador; compañero	nombre		сотрудник
miércoles; medio ambiente	nombre		среда
ayudar, asistir	verbo		помогать
batalla, combate, lucha	nombre		бой
complicado, complejo, sofisticado	adjetivo		сложный
sala	nombre		зал
oir; oler	verbo		услышать
ejército, tropa	nombre		войско
estructura	nombre		структура
a pesar de	adverbio		несмотря
usar, hacer uso, utilizar	verbo		пользоваться
protección, defensa	nombre		защита
corto	adjetivo		короткий
jefe, superior	nombre		начальник
papel	nombre		бумага
extraño	adjetivo		странный
borde; región	nombre		край
error, fallo	nombre		ошибка
iglesia	nombre		церковь
composición, estrucutura	nombre		состав
hacia aquí	adverbio		сюда
acaso, tal vez	partícula		разве
pasado	adjetivo		прошлый
tanto	adverbio		столько
idea, concepto, noción; comprensión, entendimiento	nombre		понятие
largo	adjetivo		длинный
apoyo	nombre		поддержка
edad	nombre		возраст
difícilmente, duramente, con dificultad	adverbio		трудно
rápido, veloz	adjetivo		быстрый
linea	nombre		линия
servicio; favor	nombre		услуга
felicidad; suerte	nombre		счастье
novela; aventura romántica	nombre		роман
mirar	verbo		выглядеть
haber	verbo		иметься
viento	nombre		ветер
aparecer, surgir	verbo		возникать
inglés	adjetivo		английский
encontrarse	verbo		оказываться
curso, línea; tipo de cambio	nombre		курс
búsqueda	nombre		поиск
papá	nombre		папа
el más alto, superior, supremo	adjetivo		высший
teoría	nombre		теория
antiguo, ex	adjetivo		бывший
espacio, área, extensión	nombre		пространство
estudiar, aprender	verbo		учиться
economía	nombre		экономика
limpio, puro	adjetivo		чистый
especial	adjetivo		специальный
perder	verbo		потерять
espalda	nombre		спина
comportamiento, masterrussian dot com	nombre		поведение
servir, prestar servicio	verbo		служить
arma	nombre		оружие
miedo	nombre		страх
página	nombre		страница
enemigo	nombre		враг
llamar	verbo		вызывать
veinte	número		двадцать
director	nombre		руководитель
de dónde	adverbio		откуда
mucho	adverbio		гораздо
mapa, carta; tarjeta	nombre		карта
horrible, terrorífico	adjetivo		страшный
sonido	nombre		звук
historia, relato	nombre		рассказ
esperar, aguardar	verbo		ожидать
dueño, jefe, amo	nombre		хозяин
piedra	nombre		камень
análisis, test	nombre		анализ
esperanza	nombre		надежда
de nuevo, otra vez	adverbio		вновь
caballero, señor	nombre		господин
soldado	nombre		солдат
unido, inificado	adjetivo		единый
color	nombre		цвет
sentarse	verbo		сесть
círculo	nombre		круг
intento	nombre		попытка
una vez, un día	adverbio		однажды
comentario	nombre		комментарий
cliente	nombre		клиент
golpe	nombre		удар
extremo	adjetivo		крайний
base	nombre		база
doctor	nombre		доктор
necesidad	nombre		необходимость
significar	verbo		означать
mirar	verbo		глядеть
aparecer	verbo		появляться
hija	nombre		дочь
por favor	exclamación		пожалуйста
república	nombre		республика
actuación, presentación; idea, noción	nombre		представление
poner, colocar	verbo		ставить
partir, irse (en un vehículo)	verbo		поехать
un pelo ("pelo" como idea de "cabellos" se traduce como "во́лосы") masterrussian dot com	nombre		волос
fé, creencia	nombre		вера
Alemania	nombre propio		Германия
llamarse	verbo		называться
ausencia, falta	nombre		отсутствие
recto	adjetivo		прямой
masa	nombre		масса
porcentaje; interés (financiero)	nombre		процент
largo (tiempo)	adjetivo		долгий
estudiante	nombre		студент
edificio	nombre		здание
chicos, niños	nombre		ребята
esquina, ángulo	nombre		угол
concreto, particular	adjetivo		конкретный
velocidad	nombre		скорость
requisito; solicitud	nombre		требование
querido; favorito	adjetivo		любимый
mayo	nombre propio		май
acercarse; sentar bien	verbo		подходить
correr	verbo		бежать
dirección, domicilio	nombre		адрес
al parecer, está claro, se puede ver (que)	adverbio		видно
noticia, novedad	nombre		новость
abierto	adjetivo		открытый
lista	nombre		список
volver, regresar	verbo		возвращаться
energía	nombre		энергия
conclusión; retirada	nombre		вывод
profesor	nombre		учитель
contrato, acuerdo	nombre		договор
depender de	verbo		зависеть
esfera	nombre		сфера
poner, colocar	verbo		положить
occidental	adjetivo		западный
necesario, obligatorio	adverbio		обязательно
aproximadamente	adverbio		примерно
dolor	nombre		боль
seguridad	nombre		безопасность
función	nombre		функция
mal	adverbio		плохо
científico, académico, erudito	adjetivo		учёный
habilidad, capacidad	nombre		способность
banco (institución financiera)	nombre		банк
gusto, placer	nombre		удовольствие
base, fundación; razón, fundamento	nombre		основание
hogar, casa, en casa	adverbio		дома
ajeno, extraño, de otro	adjetivo		чужой
sensación, sentimiento	nombre		ощущение
oponente, rival, enemigo, adversario	nombre		противник
de ningún modo	adverbio		никак
volumen; cantidad, capacidad, tamaño, masterrussian, dot com	nombre		объём
hacia adelante	adverbio		вперёд
escritor	nombre		писатель
estrella	nombre		звезда
crear; fundar, establecer	verbo		создавать
señal, signo, marca	nombre		знак
enteramente; en absoluto	adverbio		вовсе
influencia, impacto, efecto	nombre		влияние
seguro	adjetivo		уверенный
pecho	nombre		грудь
control, inspección	nombre		контроль
patio; corte (real)	nombre		двор
a la vez, simultaneamente	adverbio		одновременно
punto	nombre		пункт
resultar	verbo		получаться
felicidad	nombre		радость
mañana	adverbio		завтра
mayor (edad)	adjetivo		старший
impresión, sensación	nombre		впечатление
práctica	nombre		практика
dentro, por dentro	adverbio		внутри
direccón, dirigentes; manual, guía	nombre		руководство
contenido, índice; mantenimiento	nombre		содержание
voluntad	nombre		воля
enero	nombre		январь
luchador, militar	adjetivo		боевой
agarrar; ser suficiente, bastar	verbo		хватать
ayer	nombre		вчера
regimen; rutina, modo	nombre		режим
siguiente, inminente; ordinario, regular	adjetivo		очередной
salud	nombre		здоровье
crecer, aumentar	verbo		расти
coste, valor	nombre		стоимость
correcto, apropiado	adjetivo		правильный
kilómetro	nombre		километр
llamar	verbo		звать
seis	número		шесть
personalidad, identidad; masterrussian dot com; persona, individuo	nombre		личность
físico	adjetivo		физический
región	nombre		регион
boca	nombre		рот
enfermo	adjetivo		больной
resultado	nombre		итог
límite, borde, margen, frontera	nombre		предел
tal vez, a lo mejor; (él) puede	adverbio		может
lector	nombre		читатель
viejo, anciano	nombre		старик
otro	pronombre		прочий
victoria	nombre		победа
elemento	nombre		элемент
naturalmente	adverbio		естественно
permanente, constante, continuo	adjetivo		постоянный
encontrarse, juntarse, reunirse; ocurrir, suceder	verbo		встречаться
femenino	adjetivo		женский
comandante	nombre		командир
agosto	nombre		август
por primera vez	adverbio		впервые
segundo (tiempo)	nombre		секунда
feliz	adjetivo		счастливый
habitante, residente	nombre		житель
al parecer, está claro, se puede ver (que)	adverbio		видимо
vacaciones, día festivo	nombre		праздник
multitud, variedad	nombre		множество
parece (ser que)	adverbio		кажется
suma, total	nombre		сумма
escena, escenario	nombre		сцена
cuánto, hasta qué punto	adverbio		насколько
comer; ser, estar	verbo		есть
apenas, casi	adverbio		едва
técnica, tecnología; maquinaria, equipamiento	nombre		техника
pequeño	adjetivo		малый
preparación	nombre		подготовка
ligero; fácil	adjetivo		лёгкий
pena, lástima	nombre		сожаление
oreja	nombre		ухо
histórico	adjetivo		исторический
actividad, ocupación; lección	nombre		занятие
correspondiente, respectivo, apropiado; masterrussian	adjetivo		соответствующий
existencia	nombre		существование
hombre	nombre		мужик
urbano	adjetivo		городской
octubre	nombre		октябрь
recientemente, últimamente	adverbio		недавно
nariz	nombre		нос
criatura; esencia	nombre		существо
absolutamente	adverbio		абсолютно
poseer, tener	verbo		обладать
marco, límite	nombre		рамка
comenzar, empezar	verbo		начинаться
general	nombre		генерал
gracias a, debido a	preposición		благодаря
significar, querer decir	verbo		значить
mucho	pronombre		многое
francés	adjetivo		французский
correctamente, apropiadamente	adverbio		правильно
septiembre	nombre		сентябрь
izquierdo	adjetivo		левый
universidad	nombre		университет
considerar, tener en cuenta	verbo		считаться
privado, particular	adjetivo		частный
profundo	adjetivo		глубокий
muchos	pronombre		многие
club; nube	nombre		клуб
pertenecer	verbo		принадлежать
verano	nombre		лето
expresión	nombre		выражение
pagar	verbo		платить
tranquilamente	adverbio		спокойно
ropa	nombre		одежда
por, en provecho de, a causa de	preposición		ради
automóvil	nombre		автомобиль
venta	nombre		продажа
santo, sagrado	nombre		святой
financiero	adjetivo		финансовый
diciembre	nombre		декабрь
teatro	nombre		театр
en algún lugar	adverbio		где-то
URSS (Unión de Repúblicas Socialistas Soviéticas)	nombre propio		СССР
creación; masterrussian dot com; producto (matemáticas)	nombre		произведение
pueblo, aldea	nombre		деревня
Federación Rusa (iniciales de "Российская Федерация")	nombre propio		РФ
fondo, fundación	nombre		фонд
hermana	nombre		сестра
distinguirse	verbo		отличаться
gritar	verbo		кричать
observar, vigilar, supervisar	verbo		наблюдать
Occidente	nombre propio		Запад
Francia	nombre propio		Франция
circunstancia	nombre		обстоятельство
dorado (de oro)	adjetivo		золотой
junio	nombre		июнь
dirigirse; tratar; girar	verbo		обращаться
oscuro	adjetivo		тёмный
versión, edición	nombre		версия
pero, en cambio; por esto, en consecuencia, masterrussian	conjunción		зато
ministro	nombre		министр
entero	nombre		целое
acción	nombre		акция
labio	nombre		губа
alemán	nombre		немец
adicional, extra, suplementario	adjetivo		дополнительный
juzgar	verbo		судить
esencia	nombre		суть
vacío, hueco	adjetivo		пустой
América	nombre propio		Америка
frío	adjetivo		холодный
febrero	nombre		февраль
flor	nombre		цветок
central	adjetivo		центральный
profesional	adjetivo		профессиональный
fábrica	nombre		завод
federal	adjetivo		федеральный
recepción; admisión; toma (medicamento); modo, método	nombre		приём
federación	nombre		федерация
técnico; mecánico; industrial	adjetivo		технический
peculiaridad, particularidad, característica	nombre		особенность
entendimiento, comprensión	nombre		понимание
vestir; llevar	verbo		носить
nacimiento	nombre		рождение
el más cercano	adjetivo		ближайший
enfermedad	nombre		болезнь
proyectar; actuar	verbo		выступать
plaza; área	nombre		площадь
aproximación, enfoque, modo de abordar	nombre		подход
pedir, tomar prestado; ocupar, desempeñar	verbo		занимать
nativo, cercano	adjetivo		родной
estación	nombre		станция
