l'aceto	n.	m.	vinegar
l'aglio	n.	m.	garlic
l'agnello	n.	m.	lamb
l'albicocca	n.	f.	apricot
amaro	adj.		bitter
l'ananas	n.	m. inv.	pineapple
apparecchiare (la tavola)			to set/lay the table
l'arancia	n.	f.	orange
arrostire	v.		to roast
aspro	adj.		sour
assaggiare	v.		to taste, to try, to sample
aver(e) fame			to be hungry
aver(e) sete			to be thirsty
la banana	n.		banana
il barattolo	n.		tin, can
la barbabietola	n.		beetroot
bere	v.		to drink
la bevanda	n.		drink, beverage
il bicchiere	n.		glass, tumbler
la birra	n.		beer
il biscotto	n.		biscuit
la bistecca	n.		(beef)steak
bollire	v.		to boil
i broccoli	n.		broccoli
il burro	n.		butter
il caffè	n.	inv.	coffee
caldo	adj.		warm, hot
la carne	n.		meat
la carne di maiale			pork
la carota	n.		carrot
il cavolfiore	n.		cauliflower
il cavolo	n.		cabbage
la cena	n.		dinner, supper, evening meal
cenare	v.		to have dinner/supper, to dine
il cetriolo	n.		cucumber
il cibo	n.		food
la ciliegia	n.		cherry
la cipolla	n.		onion
la colazione	n.		breakfast
il coltello	n.		knife
il condimento	n.		seasoning, dressing, condiment
congelato	adj.		frozen
il conto	n.		bill (in restaurant)
la crema	n.		cream
crudo	adj.		raw
il cucchiaio	n.		spoon
delizioso	adj.		delicious
il dolce	n.		dessert
dolce	adj.		sweet
duro	adj.		tough, hard
le erbe	n.		herbs
il fagiolo	n.		bean
fare colazione			to have breakfast
fare uno spuntino			to have a snack
la farina	n.		flour
la forchetta	n.		fork
il formaggio	n.		cheese
la fragola	n.		strawberry
fresco	adj.		fresh
friggere	v.		to fry
il frumento	n.		wheat
la frutta	n.		fruit
il fungo	n.		mushroom
il grasso	n.		fat
l'insalata	n.	f.	salad
il lampone	n.		raspberry
il latte	n.		milk
la lattuga	n.		lettuce
lavare i piatti			to wash up, to do the washing-up/dishes
la limonata	n.		lemonade
il limone	n.		lemon
il mais	n.		maize, sweetcorn
mangiare	v.		to eat
il manzo	n.		beef
la marmellata	n.		jam; marmalade
la mela	n.		apple
la melanzana	n.		aubergine
il melone	n.		melon
il menù	n.	inv.	menu
il miele	n.		honey
la minestra	n.		soup
la mora	n.		blackberry
la noce	n.		walnut; nut
l'olio	n.	m.	oil
la padella	n.		frying pan
la pancetta	n.		bacon
il pane	n.		bread; loaf (of bread)
il panino	n.		(bread)roll; sandwich
il pasticcio	n.		pie, pasty
la patata	n.		potato
la pentola	n.		(sauce)pan, (cooking) pot
il pepe	n.		(ground) pepper
il peperone	n.		pepper (vegetable)
la pera	n.		pear
la pesca	n.		peach
il pesce	n.		fish
il piattino	n.		saucer
il piatto	n.		dish, plate; course
piccante	adj.		hot, spicy
il pisello	n.		pea
poco cotto			underdone, undercooked
il pollo	n.		chicken
il pomodoro	n.		tomato
il pompelmo	n.		grapefruit
il porro	n.		leek
le posate	n.		cutlery
pranzare	v.		to (have) lunch
il pranzo	n.		lunch
preparare da mangiare			to prepare/cook a meal
il prosciutto	n.		ham
raffermo	adj.		stale
il ribes	n.	inv.	blackcurrant; redcurrant
il riso	n.		rice
salato	adj.		salty
il sale	n.		salt
la salsa	n.		sauce
la salsiccia	n.		sausage
la scodella	n.		bowl
il sedano	n.		celery
la senape	n.		mustard
il sidro	n.		cider
sparecchiare (la tavola)			to clear the table
le spezie	n.		spices
gli spinaci	n.		spinach
il succo	n.		juice
la susina	n.		plum
la tazza	n.		cup
il tè	n.	inv.	tea
tenero	adj.		tender
la torta	n.		cake
troppo cotto			overdone, overcooked
l'uovo	n.	m.	egg
l'uva	n.	f.	grapes
l'uva secca			raisin
la verdura	n.		vegetables, greens
versare	v.		to pour (out)
il vino	n.		wine
lo zucchero	n.		sugar
l'alluce	n.	m.	big toe
l'ambulanza	n.	f.	ambulance
l'ammaccatura	n.	f.	bruise
ammalarsi	v.		to fall/become ill
l'anca	n.	f.	hip
l'antisettico	n.	m.	antiseptic
l'asma	n.	f.	asthma
l'attacco di cuore			heart attack
aver(e) mal di denti			to have (a) toothache
aver(e) mal di gola			to have a sore throat
aver(e) mal di schiena			to have (a) backache
aver(e) mal di stomaco			to have (a) stomach ache
aver(e) mal di testa			to have a headache
i baffi	n.		moustache
la benda	n.		bandage
la bocca	n.		mouth
il braccio	n.		arm
la bronchite	n.		bronchitis
il cancro	n.		cancer
i capelli	n.		hair
la carne	n.		flesh
la caviglia	n.		ankle
il cerotto	n.		(sticking) plaster
il cervello	n.		brain
la chirurgia	n.		surgery
la cicatrice	n.		scar
il ciglio	n.		eyelash
il collo	n.		neck
consigliare	v.		to advise
consolare	v.		to console, to comfort
il contraccettivo	n.		contraceptive
il corpo	n.		body
la coscia	n.		thigh
il cranio	n.		skull
il cuore	n.		heart
debole	adj.		weak, feeble
il dente	n.		tooth
il diabete	n.		diabetes
la diagnosi	n.		diagnosis
il dito	n.		finger
il dito del piede			toe
il dolore	n.		pain
doloroso	adj.		painful
l'effetto collaterale			side effect
efficace	adj.		effective
l'epidemia	n.	f.	epidemic
la faccia	n.		face
fare del movimento			to (take) exercise, to do/get some exercise
il farmaco	n.		drug, medicine
il fegato	n.		liver
la ferita	n.		injury, wound
il foruncolo	n.		spot, pimple; boil
la fronte	n.		forehead
fumare	v.		to smoke
la gamba	n.		leg
il ginocchio	n.		knee
la gola	n.		throat
il gomito	n.		elbow
grave	adj.		serious, grave
la guancia	n.		cheek
guarire	v.		to cure
in buona salute			healthy, in good health
l'incidente (stradale)			(road) accident
incurabile	adj.		incurable
infettivo	adj.		infectious
l'influenza	n.	f.	influenza, flu
l'inguine	n.	m.	groin
l'iniezione	n.	f.	injection
il labbro	n.		lip
la lingua	n.		tongue
malato	adj.		ill, sick
la malattia	n.		illness, disease, sickness
la mano	n.		hand
la mascella	n.		jaw
la medicina	n.		medicine
il mento	n.		chin
morire	v.		to die
il muscolo	n.		muscle
il naso	n.		nose
la nutrizione	n.		nutrition
l'occhio	n.	m.	eye
l'operazione	n.	f.	operation
l'orecchio	n.	m.	ear
l'osso	n.	m.	bone
l'otturazione	n.	f.	filling
pallido	adj.		pale
la pancia	n.		belly, stomach
il/la paziente	n.		patient
la pelle	n.		skin
il pene	n.		penis
il petto	n.		chest
piangere	v.		to cry, to weep
il piede	n.		foot
la pillola	n.		pill
il pollice	n.		thumb
il polmone	n.		lung
il polso	n.		wrist; pulse
prendere il raffreddore			to catch/get a cold
il preservativo	n.		condom
la pressione sanguigna			blood pressure
il raffreddore	n.		cold
rauco	adj.		hoarse
il rene	n.		kidney
respirare	v.		to breathe
la ricetta	n.		prescription
riposarsi	v.		to rest
rompersi la gamba			to break one's leg
la salute	n.		health
il sangue	n.		blood
lo scheletro	n.		skeleton
la schiena	n.		back
il sedativo	n.		sedative
la sedia a rotelle			wheelchair
il seno	n.		(woman's) breast
la siringa	n.		syringe
smettere di fumare			to give up smoking, to stop/quit smoking
soffrire (di)	v.		to suffer (from)
il sonnifero	n.		sleeping pill
il sopracciglio	n.		eyebrow
la spalla	n.		shoulder
la spina dorsale			spine, backbone
la stampella	n.		crutch
lo stomaco	n.		stomach
il sudore	n.		sweat, perspiration
svenire	v.		to faint
tagliarsi il dito			to cut one's finger
il tallone	n.		heel
la tempia	n.		temple
tenersi in forma			to keep fit
il termometro	n.		thermometer
la testa	n.		head
il tumore	n.		tumour
l'ulcera	n.	f.	ulcer
l'unghia	n.	f.	(finger/toe)nail
la vagina	n.		vagina
il veleno	n.		poison; venom
la vescica	n.		bladder; blister
accendere	v.		to turn/switch on
addormentarsi	v.		to go to sleep; to fall asleep
alzarsi	v.		to get up, to rise
andare a letto			to go to bed
l'appartamento	n.	m.	flat, apartment
aprire	v.		to open
aprire le tende			to open/draw the curtains
l'armadio	n.	m.	cupboard; wardrobe
l'asciugamano	n.	m.	towel
l'aspirapolvere	n.	m. inv.	vacuum cleaner, hoover
il bagno	n.		bath; bathroom
il balcone	n.		balcony
il bollitore	n.		kettle
la camera da letto			bedroom
il caminetto	n.		fireplace, hearth
il camino	n.		chimney
il cancello	n.		gate
la carta da parati			wallpaper
a casa			at home
la casa	n.		house; home
il cassetto	n.		drawer
il cassettone	n.		chest of drawers
la chiave	n.		key
chiudere	v.		to close, to shut
chiudere le tende			to close/draw the curtains
comodo	adj.		comfortable
il congelatore	n.		freezer
la coperta	n.		blanket
costruire	v.		to build, to construct
la credenza	n.		sideboard
la cucina	n.		kitchen
la cucina a gas			gas cooker
la cucina elettrica			electric cooker
il cuscino	n.		cushion; pillow
il davanzale	n.		window sill/ledge
il dentifricio	n.		toothpaste
dentro			inside, indoors
il divano	n.		sofa, settee
la doccia	n.		shower
fare il bucato			to do the washing/laundry
fare la doccia			to have a shower
fare un bagno			to have a bath
il ferro da stiro			iron
la finestra	n.		window
il forno	n.		oven
il forno a microonde			microwave (oven)
il frigorifero	n.		refrigerator, fridge
fuori			outside, outdoors
il garage	n.	inv.	garage
il giardino	n.		garden
l'imposta	n.	f.	shutter
l'interruttore	n.	m.	switch
il lavandino	n.		sink, washbasin
lavarsi	v.		to wash (oneself), to have a wash
lavarsi i denti			to clean/brush one's teeth
la lavastoviglie	n.		dishwasher
la lavatrice	n.		washing machine
il lenzuolo	n.		sheet
il letto	n.		bed
i mobili	n.		furniture
moderno	adj.		modern
la moquette	n.		carpet
il muro	n.		wall
ordinato	adj.		tidy, orderly
la pattumiera	n.		(rubbish) bin, dustbin
il pavimento	n.		floor
pettinarsi	v.		to comb one's hair
il piano	n.		floor, storey
la poltrona	n.		armchair
la polvere	n.		dust
polveroso	adj.		dusty
la porta	n.		door
il prato	n.		lawn
la presa (di corrente)	n.		(electric) socket, power point
pulire	v.		to clean
pulito	adj.		clean
la radio	n.	inv.	radio
il registratore a cassette			cassette recorder/player
riparare	v.		to repair
il riscaldamento centrale			central heating
la sala da pranzo			dining room
il sapone	n.		soap
lo scaffale	n.		shelf; bookcase
la scala	n.		staircase, stairs
la scopa	n.		broom, brush
la scrivania	n.		(writing) desk
il secchio	n.		bucket
secco	adj.		dry
sedersi	v.		to sit down
la sedia	n.		chair
la serratura	n.		lock
lo sgabello	n.		stool
lo shampoo	n.	inv.	shampoo
la soffitta	n.		attic
il soffitto	n.		ceiling
il soggiorno	n.		living/sitting room, lounge
spazioso	adj.		spacious
la spazzola	n.		brush
lo specchio	n.		mirror
spegnere	v.		to turn/switch off
la sporcizia	n.		dirt, filth; dirtiness
sporco	adj.		dirty, filthy
la stanza	n.		room
stendere il bucato			to hang out/up the washing/laundry
stendersi	v.		to lie down
stirare	v.		to iron
lo straccio	n.		cloth, rag; duster
lo studio	n.		study
la stuoia	n.		mat
la sveglia	n.		alarm clock
il tappeto	n.		rug, mat
il tavolo	n.		table
il telefono	n.		telephone
la televisione	n.		television
la tenda	n.		curtain
il termosifone	n.		radiator
il tetto	n.		roof
la toilette	n.	inv.	toilet
umido	adj.		damp, moist; humid; wet
il vaso	n.		vase; pot, jar
verniciare	v.		to paint; to varnish
il videoregistratore	n.		video (cassette) recorder, video
l'alpinismo	n.	m.	mountaineering, climbing
applaudire	v.		to applaud, to clap
l'applauso	n.	m.	applause
l'arbitro	n.	m.	referee; umpire
l'arte	n.	f.	art
ascoltare	v.		to listen (to)
l'asso di picche			ace of spades
l'atletica	n.	f.	athletics
ballare	v.		to dance
barare	v.		to cheat
la batteria	n.		drums, drum kit
il biliardo	n.		billiards, pool
calciare	v.		to kick
il calcio	n.		football
cantare	v.		to sing
la canzone	n.		song
il capitolo	n.		chapter
la chitarra	n.		guitar
il clarinetto	n.		clarinet
la commedia	n.		comedy; play
commovente	adj.		moving, touching
il concerto	n.		concert; concerto
il coro	n.		chorus, choir
la corsa	n.		running; race
il cricket	n.		cricket
il cruciverba	n.	inv.	crossword
dipingere	v.		to paint
disegnare	v.		to draw
il disegno	n.		drawing
divertente	adj.		entertaining, enjoyable, pleasant; amusing, funny
il divertimento	n.		amusement, pleasure, entertainment
divertirsi	v.		to amuse/enjoy oneself
il documentario	n.		documentary
la donna di cuori			queen of hearts
eccellente	adj.		excellent
il fante di quadri			jack of diamonds
fare un gol			to score a goal
il film	n.	inv.	film, movie
il film dell'orrore			horror film/movie
il flauto	n.		flute
la gara	n.		competition, contest
la ginnastica	n.		gymnastics
giocare	v.		to play
giocare a calcio			to play football
giocare a carte			to play cards
giocare a tennis			to play tennis
il gioco	n.		game
il giornale	n.		newspaper
il golf	n.		golf
guardare	v.		to watch, to look at
improvvisare	v.		to improvise
l'intervallo	n.	m.	interval; half-time
l'ippica	n.	f.	horse-racing
il jazz	n.		jazz
leggere	v.		to read
la letteratura	n.		literature
il libro	n.		book
la mazza	n.		bat; (golf) club
la mostra d'arte			art exhibition
la musica	n.		music
la musica classica			classical music
la musica pop			pop music
le notizie	n.		news
nuotare	v.		to swim
il nuoto	n.		swimming
l'oboe	n.	m.	oboe
l'opera	n.	f.	(artistic) work; opera
l'orchestra	n.	f.	orchestra
il palcoscenico	n.		stage
la palla	n.		ball
la pallacanestro	n.		basketball
il pareggio	n.		draw, tie
la partita	n.		match, game
il passatempo	n.		pastime, hobby
il pattinaggio	n.		skating
il pennello	n.		(paint)brush
perdere	v.		to lose
piacevole	adj.		pleasant, agreeable
il pianoforte	n.		piano
la poesia	n.		poetry; poem
popolare	adj.		popular
preferire	v.		to prefer
il programma (televisivo)	n.		(television) programme
la prova generale			dress rehearsal
il pugilato	n.		boxing
il quadro	n.		picture
la racchetta	n.		racket/racquet, bat
il racconto	n.		story, tale; short story
il re di fiori			king of clubs
la recensione (di libri)	n.		(book) review
recitare	v.		to recite; to perform, to act; to play (the part of)
il ritratto	n.		portrait
la rivista	n.		magazine
il romanzo	n.		novel
il romanzo giallo			crime novel, detective story, thriller
il sassofono	n.		saxophone
gli scacchi	n.		chess
lo schizzo	n.		sketch
lo sci	n.		skiing; ski
la scultura	n.		sculpture
sentimentale	adj.		sentimental
spaventoso	adj.		frightening; frightful, dreadful
lo spettacolo	n.		show; performance
gli spettatori	n.		audience, spectators
spiacevole	adj.		unpleasant, disagreeable
lo sport	n.		sport
la squadra	n.		team
lo strumento	n.		instrument
suonare a orecchio			to play by ear
suonare a prima vista			to sight-read, to play at sight
suonare il pianoforte			to play the piano
suonare la chitarra			to play the guitar
il tamburo	n.		drum
la tela	n.		canvas
il tempo libero			free/spare time
il tennis	n.		tennis
il tifoso	n.		fan, supporter
tirare i dadi			to throw the dice
il titolo	n.		title
la tragedia	n.		tragedy
la tromba	n.		trumpet
il trombone	n.		trombone
la vela	n.		sailing
vincere	v.		to win
il violino	n.		violin
il violoncello	n.		cello
accoppiarsi	v.		to mate
l'acqua	n.	f.	water
l'acquazzone	n.	m.	(heavy) shower, downpour
addomesticato	adj.		tame, domesticated
l'albero	n.	m.	tree
l'alluvione	n.	f.	flood
l'animale	n.	m.	animal
l'ape	n.	f.	bee
l'aquila	n.	f.	eagle
l'arbusto	n.	m.	shrub
l'arcobaleno	n.	m.	rainbow
l'aria	n.	f.	air
l'asino	n.	m.	donkey, ass
l'atmosfera	n.	f.	atmosphere
la baia	n.		bay
il bosco	n.		wood(s)
la brezza	n.		breeze
brillare	v.		to shine
bruciare	v.		to burn
fa caldo			it's hot/warm
il cane	n.		dog
la cascata	n.		waterfall
il cavallo	n.		horse
il cespuglio	n.		bush
il cielo	n.		sky
il clima	n.		climate
il coccodrillo	n.		crocodile
la collina	n.		hill
il coniglio	n.		rabbit
il continente	n.		continent; mainland
la costa	n.		coast
la costellazione	n.		constellation
crescere	v.		to grow
il deserto	n.		desert
l'elefante	n.	m.	elephant
l'erba	n.	f.	grass; herb
erodere	v.		to erode
la farfalla	n.		butterfly
fertile	adj.		fertile
il fiore	n.		flower
fiorire	v.		to flower; to blossom
il fiume	n.		river
la foglia	n.		leaf
la foresta	n.		forest
la formica	n.		ant
fa freddo			it's cold
il fuoco	n.		fire
la galassia	n.		galaxy
il gatto	n.		cat
la gemma	n.		bud
il ghiaccio	n.		ice
la giungla	n.		jungle
la grandine	n.		hail
il gufo	n.		owl
imputridire	v.		to rot, to decay
l'insetto	n.	m.	insect
l'isola	n.	f.	island
il lago	n.		lake
il lampo	n.		(flash of) lightning
il leone	n.		lion
la lumaca	n.		slug; snail
la luna	n.		moon
il lupo	n.		wolf
il maiale	n.		pig
il mare	n.		sea
la marea	n.		tide
il mondo	n.		world
la montagna	n.		mountain(s)
morto	adj.		dead
la mucca	n.		cow
la natura	n.		nature
naturale	adj.		natural
la nebbia	n.		fog, mist
c'è nebbia			it's foggy
la neve	n.		snow
nevica			it's snowing
la nuvola	n.		cloud
è nuvoloso			it's cloudy
l'oceano	n.	m.	ocean
l'onda	n.	f.	wave
l'orso	n.	m.	bear
la palude	n.		marsh, bog, swamp
la pecora	n.		sheep
il pesce	n.		fish
il pianeta	n.		planet
la pianta	n.		plant
la pietra	n.		stone
la pioggerella	n.		drizzle
la pioggia	n.		rain
piove			it's raining
il pipistrello	n.		bat
il pollo	n.		chicken
il prato	n.		meadow
prendere fuoco			to catch fire
profondo	adj.		deep
la radice	n.		root
il ragno	n.		spider
il ramo	n.		branch
riprodursi	v.		to reproduce, to breed
la riva	n.		shore, (river)bank
la roccia	n.		rock
il ruscello	n.		stream
la sabbia	n.		sand
lo scarafaggio	n.		cockroach
secco	adj.		dry
selvatico	adj.		wild
il seme	n.		seed
il serpente	n.		snake
il sistema solare	n.		solar system
soffiare	v.		to blow
c'è il sole			it's sunny
il sole	n.		sun
lo spazio	n.		space
la spina	n.		thorn; spine, prickle
lo stagno	n.		pond
la stella	n.		star
lo stelo	n.		stem
il tempo	n.		weather
il temporale	n.		(thunder)storm
la terra	n.		earth; soil; land
il terremoto	n.		earthquake
la tigre	n.		tiger
il topo	n.		mouse
il tronco (d'albero)	n.		(tree) trunk
il tuono	n.		thunder
l'uccello	n.	m.	bird
umido	adj.		humid; damp, moist, wet
l'universo	n.	m.	universe
l'uragano	n.	m.	hurricane
la valanga	n.		avalanche
la valle	n.		valley
la vegetazione	n.		vegetation
c'è vento			it's windy
il vento	n.		wind
il verme	n.		worm
la vespa	n.		wasp
vivo	adj.		alive, living
la volpe	n.		fox
il vulcano	n.		volcano
la zanzara	n.		mosquito
l'adolescenza	n.	f.	adolescence
l'adulto	n.	m.	adult
aggressivo	adj.		aggressive
allegro	adj.		cheerful, merry
amare	v.		to love
ambizioso	adj.		ambitious
amichevole	adj.		friendly
l'amico	n.	m.	(male) friend
l'architetto	n.	m.	architect
arrogante	adj.		arrogant
l'artista	n.	m. or f.	artist
l'attore	n.	m.	actor
l'attrice	n.	f.	actress
il bambino	n.		(male) baby/child
bello	adj.		beautiful; handsome
il bibliotecario	n.		(male) librarian
brutto	adj.		ugly
il cameriere	n.		waiter
il camionista	n.		lorry driver
il/la cantante	n.		singer
la casalinga	n.		housewife
cattivo	adj.		bad, wicked
il chirurgo	n.		surgeon
il cognome	n.		surname, last name
il commesso	n.		(male) shop/sales assistant
compatire	v.		to sympathize with, to feel sorry for
il compositore	n.		(male) composer
conoscere	v.		to know, to be acquainted with
il costruttore	n.		builder
crudele	adj.		cruel
il cugino	n.		(male) cousin
il cuoco	n.		(male) cook
la data di nascita			date of birth
debole	adj.		weak, feeble
il/la dentista	n.		dentist
depresso	adj.		depressed
il diplomatico	n.		diplomat
dispettoso	adj.		spiteful
disprezzare	v.		to despise
la donna	n.		woman
l'elettricista	n.	m.	electrician
l'età	n.	f. inv.	age
la famiglia	n.		family
famoso	adj.		famous
felice	adj.		happy
fidarsi (di)	v.		to trust
la figlia	n.		daughter
il figlio	n.		son
forte	adj.		strong
il fotografo	n.		(male) photographer
il fratello	n.		brother
il funerale	n.		funeral
geloso	adj.		jealous
il gemello	n.		(male) twin
il genero	n.		son-in-law
generoso	adj.		generous
gentile	adj.		kind
il giardiniere	n.		(male) gardener
il/la giornalista	n.		journalist
giovane	adj.		young
il/la giudice	n.		judge
l'idraulico	n.	m.	plumber
l'indirizzo	n.	m.	address
l'infanzia	n.	f.	childhood
l'infermiere	n.	m.	(male) nurse
l'ingegnere	n.	m.	engineer
innamorarsi (di)	v.		to fall in love (with)
insultare	v.		to insult
intelligente	adj.		intelligent
invidiare	v.		to envy
lusingare	v.		to flatter
la madre	n.		mother
il marinaio	n.		sailor
il marito	n.		husband
la matrigna	n.		stepmother
il matrimonio	n.		marriage; wedding
il meccanico	n.		mechanic
il medico	n.		doctor
il minatore	n.		miner
modesto	adj.		modest
la moglie	n.		wife
morire	v.		to die
la morte	n.		death
il/la musicista	n.		musician
nascere	v.		to be born
la nascita	n.		birth
nervoso	adj.		nervous
la nipote	n.		granddaughter
il nipote	n.		grandson
il nome	n.		name
la nonna	n.		grandmother
il nonno	n.		grandfather
il numero di telefono			telephone number
la nuora	n.		daughter-in-law
odiare	v.		to hate, to detest
il padre	n.		father
il/la parente	n.		relative, relation
il parrucchiere	n.		(male) hairdresser
il patrigno	n.		stepfather
perdonare	v.		to forgive, to pardon, to excuse
la persona	n.		person
il pescatore	n.		fisherman
il/la pilota	n.		pilot
il pittore	n.		(male) painter
il politico	n.		(male) politician
il poliziotto	n.		policeman
il pompiere	n.		fireman, fire-fighter
il postino	n.		postman
povero	adj.		poor
la professione	n.		profession, occupation
la ragazza	n.		girl; girlfriend
il ragazzo	n.		boy; boyfriend
il ragioniere	n.		(male) accountant
ricco	adj.		rich, wealthy
saggio	adj.		wise
lo scienziato	n.		(male) scientist
lo scrittore	n.		(male) writer
il segretario	n.		(male) secretary
simpatico	adj.		nice, pleasant, likeable
il soldato	n.		soldier
la sorella	n.		sister
la spia	n.		spy
spietato	adj.		ruthless, pitiless
sposarsi	v.		to get married
stupido	adj.		stupid
la suocera	n.		mother-in-law
il suocero	n.		father-in-law
il/la tassista	n.		taxi driver
timido	adj.		shy, timid
triste	adj.		sad
l'uomo	n.	m.	man
l'uomo d'affari			businessman
vecchio	adj.		old
la vita	n.		life
vivere	v.		to live
la zia	n.		aunt, aunty/auntie
lo zio	n.		uncle
accettare	v.		to accept
l'ambasciata	n.	f.	embassy
l'arma	n.	f.	weapon, arm
arrendersi	v.		to surrender
assassinare	v.		to murder; to assassinate
l'assassinio	n.	m.	murder; assassination
attaccare	v.		to attack
l'attacco	n.	m.	attack
l'aviazione (militare)	n.	f.	air force
la bomba	n.		bomb
il buddismo	n.		Buddhism
il/la buddista	n.		Buddhist
la cerimonia	n.		ceremony
civilizzato	adj.		civilized
colpevole	adj.		guilty
combattere	v.		to fight
il commercio	n.		trade, commerce
commettere un crimine			to commit a crime
la comunità	n.	inv.	community
condannare a morte			to condemn/sentence to death
conformarsi (a)	v.		to conform (to)
la conquista	n.		conquest
conquistare	v.		to conquer
il contratto	n.		contract
controverso	adj.		controversial
la corruzione	n.		corruption; bribery
credere	v.		to believe
la criminalità	n.		crime, criminality
il cristianesimo	n.		Christianity
il cristiano	n.		Christian (man)
la cultura	n.		culture
il debito	n.		debt
la democrazia	n.		democracy
dichiarare guerra (a)			to declare war (on)
dichiararsi colpevole			to plead guilty
dichiararsi innocente			to plead not guilty, to plead innocent
discutere	v.		to discuss, to debate; to question, to dispute
la disoccupazione	n.		unemployment
la dittatura	n.		dictatorship
l'ebreo	n.	m.	Jew, Jewish man
l'economia	n.	f.	economy; economics
economico	adj.		economic; economical
eleggere	v.		to elect
l'elezione	n.	f.	election
l'esercito	n.	m.	army
essere d'accordo (con)			to agree (with)
la fabbrica	n.		factory
la frode	n.		fraud
il fucile	n.		rifle, gun
il furto	n.		theft, robbery
il giudaismo	n.		Judaism
la giuria	n.		jury
la giustizia	n.		justice
giusto	adj.		fair, just
governare	v.		to govern, to rule
il governo	n.		government
la guerra	n.		war
illegale	adj.		illegal
imparziale	n.		impartial, unbiased
importante	adj.		important
l'incendio doloso			arson
l'indipendenza	n.	f.	independence
l'indù	n.	m. or f.	Hindu
l'industria	n.	f.	industry
l'inflazione	n.	f.	inflation
ingiusto	adj.		unfair, unjust
innocente	adj.		innocent
invadere	v.		to invade
l'invasione	n.	f.	invasion
l'investimento	n.	m.	investment
l'Islam	n.	m.	Islam
legale	adj.		legal
la legge	n.		law
la libertà	n.	inv.	freedom, liberty
la maggioranza	n.		majority
la marina	n.		navy
la minoranza	n.		minority
moderno	adj.		modern
la monarchia	n.		monarchy
il musulmano	n.		Moslem/Muslim (man)
la nazionalità	n.		nationality
l'oppressione	n.	f.	oppression
la pace	n.		peace
il partito	n.		(political) party
la pena capitale			capital punishment
pericoloso	adj.		dangerous
la politica	n.		politics
politico	adj.		political
la polizia	n.		police
la popolazione	n.		population
potente	adj.		powerful, strong
pregare	v.		to pray
la preghiera	n.		prayer
il presidente	n.		president
la prigione	n.		prison, jail
privato	adj.		private
il processo	n.		trial
il profitto	n.		advantage, profit, benefit
proibire	v.		to prohibit, to forbid
protestare	v.		to protest
pubblico	adj.		public
punire	v.		to punish
la punizione	n.		punishment
il re	n.	inv.	king
realizzare un profitto			to make a profit
la regina	n.		queen
la religione	n.		religion
ribellarsi (a)	v.		to rebel (against)
il ricatto	n.		blackmail
rifiutare di fare			to refuse to do
rubare	v.		to steal
santo	adj.		holy
la schiavitù	n.		slavery
scioperare	v.		to (go on) strike
lo sciopero	n.		strike, walkout
la sentenza	n.		judgement, sentence
sicuro	adj.		safe, secure
il sindacato	n.		trade union
la società	n.	inv.	society
il sondaggio (d'opinioni)			(opinion) poll
suicidarsi	v.		to commit suicide
il tasso di interesse			interest rate
il terrorismo	n.		terrorism
il/la testimone	n.		witness
torturare	v.		to torture
il tradimento	n.		betrayal; treason
la tradizione	n.		tradition
uccidere	v.		to kill
il vandalismo	n.		vandalism
il verdetto	n.		verdict
violentare	v.		to rape
votare	v.		to vote
abbronzarsi	v.		to get a (sun)tan
abbronzato	adj.		(sun)tanned
l'aeroplano	n.	m.	(aero)plane
l'aeroporto	n.	m.	airport
l'Africa	n.	f.	Africa
l'albergo	n.	m.	hotel
l'America del Nord			North America
l'America del Sud			South America
andare all'estero			to go abroad
andare in vacanza			to go on holiday
arrivare	v.		to arrive
l'Asia	n.	f.	Asia
atterrare	v.		to land, to touch down
l'Australia	n.	f.	Australia
australiano	adj.		Australian
l'Austria	n.	f.	Austria
austriaco	adj.		Austrian
l'autobus	n.	m. inv.	bus
l'autostrada	n.	f.	motorway
avere il mal di mare			to be/feel seasick
i bagagli	n.		luggage, baggage
belga	adj.		Belgian
il Belgio	n.		Belgium
la benzina	n.		petrol
la bicicletta	n.		bicycle, bike
il biglietto	n.		ticket
il Brasile	n.		Brazil
britannico	adj.		British
il campeggio	n.		camping; campsite
il Canada	n.		Canada
canadese	adj.		Canadian
capire	v.		to understand
la cartolina	n.		postcard
la Cina	n.		China
cinese	adj.		Chinese
la città	n.	inv.	town, city
danese	adj.		Danish
la Danimarca	n.		Denmark
decollare	v.		to take off, to leave the ground
la direzione	n.		direction
disfare le valigie			to unpack (one's bags)
la dogana	n.		customs
l'Egitto	n.	m.	Egypt
egiziano	adj.		Egyptian
l'equatore	n.	m.	equator
esotico	adj.		exotic
esplorare	v.		to explore
l'est	n.	m.	(the) east
l'Europa	n.	f.	Europe
fare le valigie			to pack (one's bags)
faticoso	adj.		tiring
la ferrovia	n.		railway
francese	adj.		French
la Francia	n.		France
la frontiera	n.		border, frontier
il Galles	n.		Wales
gallese	adj.		Welsh
la Germania	n.		Germany
il Giappone	n.		Japan
giapponese	adj.		Japanese
la gita	n.		excursion, trip, outing
il giubbotto di salvataggio			life jacket
la Grecia	n.		Greece
greco	adj.		Greek
l'India	n.	f.	India
l'Inghilterra	n.	f.	England
inglese	adj.		English
l'Irlanda	n.	f.	Ireland
irlandese	adj.		Irish
l'Italia	n.	f.	Italy
italiano	adj.		Italian
leggero	adj.		light
lento	adj.		slow
la lingua	n.		language
la macchina	n.		car
il mar Baltico			Baltic Sea
il mar Mediterraneo			Mediterranean Sea
il mar Nero			Black Sea
il mare del Nord			North Sea
il Messico	n.		Mexico
il mondo	n.		world
la motocicletta	n.		motorcycle, motorbike
la nave	n.		ship, boat
il nord	n.		(the) north
nordamericano	adj.		North American
norvegese	adj.		Norwegian
la Norvegia	n.		Norway
la Nuova Zelanda			New Zealand
l'Oceano antartico			Antarctic Ocean
l'Oceano artico			Arctic Ocean
l'Oceano Atlantico			Atlantic Ocean
l'Oceano Indiano			Indian Ocean
l'Oceano Pacifico			Pacific Ocean
l'Olanda	n.	f.	Holland
olandese	adj.		Dutch
l'ostello della gioventù			youth hostel
l'ovest	n.	m.	(the) west
il paese	n.		country, nation; village
i Paesi Bassi			(the) Netherlands
parlare italiano			to speak Italian
partire	v.		to leave, to depart
il passaporto	n.		passport
pesante	adj.		heavy
polacco	adj.		Polish
il Polo Nord			North Pole
il Polo Sud			South Pole
la Polonia	n.		Poland
il porto	n.		harbour, port
il Portogallo	n.		Portugal
portoghese	adj.		Portuguese
prenotare	v.		to book, to reserve
rapido	adj.		fast, quick, rapid
la regione	n.		region, area
il Regno Unito			(the) United Kingdom
remoto	adj.		remote
la Russia	n.		Russia
russo	adj.		Russian
la Scozia	n.		Scotland
scozzese	adj.		Scottish
la Spagna	n.		Spain
spagnolo	adj.		Spanish
la spiaggia	n.		beach
gli Stati Uniti			(the) United States
la stazione	n.		station
la stazione di rifornimento			petrol station
straniero	adj.		foreign
strano	adj.		strange, odd
il sud	n.		(the) south
sudamericano	adj.		South American
svedese	adj.		Swedish
la Svezia	n.		Sweden
la Svizzera	n.		Switzerland
svizzero	adj.		Swiss
il taxi	n.	inv.	taxi
tedesco	adj.		German
la tenda	n.		tent
il tram	n.	inv.	tram
il treno	n.		train
tropicale	adj.		tropical
la Turchia	n.		Turkey
turco	adj.		Turkish
il turismo	n.		tourism
ungherese	adj.		Hungarian
l'Ungheria	n.	f.	Hungary
la vacanza	n.		holiday(s)
la valigia	n.		suitcase
viaggiare	v.		to travel
il viaggio	n.		travel; journey, trip
il villaggio	n.		village
il visto	n.		visa
lo zaino	n.		rucksack, backpack
affollato	adj.		crowded
l'aiuola	n.	f.	flower bed
andare a fare acquisti			to go shopping
andare in città			to go (in)to town
l'angolo	n.	m.	corner
l'arco	n.	m.	arch
l'ascensore	n.	m.	lift
l'assegno	n.	m.	cheque
attraversare la strada			to cross the road/street
la banca	n.		bank
la banconota	n.		banknote
il bar	n.	inv.	bar
di bassa qualità			(of) poor/low quality
la biblioteca	n.		library
a buon mercato			cheap, inexpensive
di buona qualità			(of) good/high quality
la cabina telefonica			telephone box/booth
il caffè	n.	inv.	café/cafe
il camerino	n.		fitting/changing room
il cancello	n.		gate
il cantiere	n.		building site
caro	adj.		dear, expensive
la carta di credito			credit card
il cartello stradale			(road)sign, signpost
la cartoleria	n.		stationer's (shop), stationery shop
la caserma dei pompieri			fire station
la cassa	n.		checkout, cash desk
la cassetta delle lettere			postbox, pillar box
la cattedrale	n.		cathedral
il centro commerciale			shopping centre
cercare	v.		to look for, to search for
la chiesa	n.		church
il cinema	n.	inv.	cinema
il circo	n.		circus
il/la cliente	n.		customer, client
comprare	v.		to buy
contare	v.		to count
costare	v.		to cost
l'edicola	n.	f.	(newspaper) kiosk, news stand
l'edificio	n.	m.	building
l'entrata	n.	f.	entrance, way in
fare la fila			to queue (up), to form a queue
fare la spesa			to do the (food) shopping
(andare a) fare una passeggiata			to go for a walk
la farmacia	n.		chemist's (shop)
la fontana	n.		fountain
la galleria	n.		tunnel; gallery
la gioielleria	n.		jeweller's (shop), jewellery shop
girare a destra			to turn right
girare a sinistra			to turn left
il grande magazzino			department store
l'incrocio	n.	m.	crossroads, junction
l'ingorgo (stradale)	n.	m.	traffic jam
il lampione	n.		street light/lamp; lamppost
largo	adj.		wide, broad
la libreria	n.		bookshop
il locale notturno			nightclub
la macelleria	n.		butcher's (shop)
il marciapiede	n.		pavement
il mercato	n.		market
la moneta	n.		coin
il monumento	n.		monument
la moschea	n.		mosque
il municipio	n.		town council; town hall
il museo	n.		museum
il negozio	n.		shop
il negozio di calzature			shoe shop
il negozio di giocattoli			toyshop
nuovo di zecca			brand-new
gli oggetti smarriti			lost property
l'ospedale	n.	m.	hospital
pagare	v.		to pay
pagare con carta di credito			to pay by credit card
pagare in contanti			to pay (in) cash
la panchina	n.		(park) bench
la panetteria	n.		baker's (shop), bakery
il parcheggio	n.		car park; parking space
il parco	n.		park
il passaggio pedonale			pedestrian crossing
la pasticceria	n.		cake shop
perdersi	v.		to get lost
la pescheria	n.		fish shop, fishmonger's (shop)
al piano terra			on the ground floor
la piazza	n.		(town) square
la piscina	n.		swimming pool/baths
il ponte	n.		bridge
al primo piano			on the first floor
provare una gonna			to try on a skirt
il regalo	n.		present, gift
il registratore di cassa			cash register, till
la ricevuta	n.		receipt
il rimborso	n.		refund, repayment
il ristorante	n.		restaurant
la scala mobile			escalator
scegliere	v.		to choose, to select
lo sconto	n.		discount
di seconda mano			second-hand
il semaforo	n.		(set of) traffic lights
la sinagoga	n.		synagogue
i soldi	n.		money
il sottopassaggio	n.		underpass, subway
lo sportello automatico	n.		cash machine/dispenser
lo stadio	n.		stadium
stancarsi	v.		to get/grow tired
la statua	n.		statue
la stazione di polizia			police station
la strada	n.		road, street
stretto	adj.		narrow
il supermercato	n.		supermarket
il teatro	n.		theatre
tornare a casa			to go/return home
il traffico	n.		traffic
trovare	v.		to find
l'ufficio	n.	m.	office
l'ufficio postale			post office
l'uscita	n.	f.	exit, way out
vendere	v.		to sell
la vetrina	n.		shop window; display cabinet/case
il vicolo cieco			blind alley, dead end, cul-de-sac
lo zoo	n.	inv.	zoo
l'arte	n.	f.	art
l'atletica	n.	f.	athletics
attento	adj.		attentive; careful, thorough
l'aula	n.	f.	classroom; lecture theatre
il banco	n.		desk
la biologia	n.		biology
birichino	adj.		mischievous, naughty
la calcolatrice	n.		calculator
il campo sportivo			playing field, sports ground
cancellare	v.		to cross out; to rub out, to erase
capire	v.		to understand
il certificato	n.		certificate
chiedere	v.		to ask; to ask for
la chimica	n.		chemistry
colto	adj.		cultured, (well-)educated
il compito	n.		task; (piece of) homework
complicato	adj.		complicated
comportarsi bene			to behave (well), to behave oneself
comportarsi male			to misbehave, to behave badly
la composizione	n.		composition, essay
il computer	n.	inv.	computer
copiare	v.		to copy
corretto	adj.		correct, right
il corso per corrispondenza			correspondence course
il corso serale			evening class(es)
creativo	adj.		creative
dare il buon esempio			to set a good example
dare il cattivo esempio			to set a bad example
il dettato	n.		dictation
difficile	adj.		difficult
dimenticare	v.		to forget
disattento	adj.		inattentive
disubbidiente	adj.		disobedient
il dizionario	n.		dictionary
la domanda	n.		question; demand; request
i due punti			colon
l'economia	n.	f.	economics
l'educazione fisica			physical education, PE
entusiasta	adj.		enthusiastic, keen
l'esame	n.	m.	exam
l'esame di ammissione			entrance exam
l'esempio	n.	m.	example
l'esercizio	n.	m.	exercise
facile	adj.		easy
fare un esame			to take/sit an exam
fare una domanda			to ask a question
la filosofia	n.		philosophy
finire la scuola			to leave school
la fisica	n.		physics
fraintendere	v.		to misunderstand
la frase	n.		sentence; phrase
frequentare	v.		to attend
la geografia	n.		geography
il gesso	n.		chalk
la gomma	n.		rubber, eraser
la grammatica	n.		grammar
imparare	v.		to learn
imparare a memoria			to learn by heart, to memorize
indicare	v.		to point to/out, to indicate
l'informatica	n.	f.	computer science, information technology
l'insegnamento	n.	m.	teaching, education
l'insegnante	n.	m. or f.	teacher
insegnare	v.		to teach
interessante	adj.		interesting
la laurea	n.		(university) degree
laurearsi	v.		to graduate
la lavagna	n.		blackboard
leggere	v.		to read
la letteratura	n.		literature
la lezione	n.		lesson; lecture
il libro di testo			textbook
la matematica	n.		mathematics, maths
la materia	n.		(school) subject
la matita	n.		pencil
la musica	n.		music
noioso	adj.		boring
non superare un esame			to fail an exam
il nuoto	n.		swimming
l'orario	n.	m.	timetable
la pagina	n.		page
il paragrafo	n.		paragraph
la penna	n.		pen
pigro	adj.		lazy
la politica	n.		politics
preciso	adj.		precise, accurate
il/la preside	n.		headteacher, headmaster/headmistress
il professore	n.		(male) lecturer; (male) professor
il programma	n.		syllabus, curriculum
la psicologia	n.		psychology
la punteggiatura	n.		punctuation
il punto	n.		full stop; point; dot
il punto e virgola			semicolon
il punto esclamativo			exclamation mark
il punto interrogativo			question mark
il quaderno	n.		exercise book, notebook
la qualifica	n.		qualification
la religione	n.		religious studies/education
ricordare	v.		to remember
la ricreazione	n.		break
il righello	n.		ruler
rispondere a una domanda			to answer a question
la risposta	n.		answer, reply
il risultato	n.		result
sapere	v.		to know
lo sbaglio	n.		mistake
le scienze	n.		science(s)
lo scolaro	n.		schoolboy
scrivere	v.		to write
la scuola	n.		school
la scuola materna			nursery school, kindergarten
semplice	adj.		simple
la sociologia	n.		sociology
sottolineare	v.		to underline
la storia	n.		history
lo studente	n.		(male) student
studiare	v.		to study
superare un esame			to pass an exam
il tema	n.		theme
la teologia	n.		theology
ubbidiente	adj.		obedient
l'università	n.	f. inv.	university
il voto	n.		mark, grade
abbottonare	v.		to button (up), to do up
l'ago	n.	m.	needle
alla/di moda			fashionable, in fashion
l'anello	n.	m.	ring
annodare	v.		to knot, to tie
arancione	adj.	inv.	orange
argenteo	adj.		silver (in colour), silvery
d'argento			(made) of silver, silver
attraente	adj.		attractive
azzurro	adj.		(pale) blue
la biancheria intima			underwear
bianco	adj.		white
blu	adj.	inv.	(dark) blue
il borsellino	n.		purse
la borsetta	n.		handbag
il bottone	n.		button
il braccialetto	n.		bracelet, bangle
la calza	n.		stocking
la calzatura	n.		footwear
il calzino	n.		sock
i calzoncini	n.		shorts
cambiarsi	v.		to change, to get changed
la camicetta	n.		blouse
la camicia	n.		shirt
la camicia da notte			nightdress, nightie; nightshirt
la canottiera	n.		vest
il cappello	n.		hat
il cappotto	n.		(over)coat
la cerniera	n.		zip
la cintura	n.		belt
la collana	n.		necklace
il collant	n.	inv.	tights
il colletto	n.		collar
il colore	n.		colour
comodo	adj.		comfortable
il completo	n.		suit
consumare	v.		to wear out
corto	adj.		short
il costume da bagno			swimming/bathing costume, swimming trunks
il cotone	n.		cotton
la cravatta	n.		tie
cucire	v.		to sew
il cuoio	n.		leather
dorato	adj.		gold (in colour), golden
elegante	adj.		elegant
il fazzoletto	n.		handkerchief; (head)scarf
il filo	n.		thread
la fodera	n.		lining
la giacca	n.		jacket
giallo	adj.		yellow
i gioielli	n.		jewellery, jewels
la gonna	n.		skirt
grigio	adj.		grey
il guanto	n.		glove
l'impermeabile	n.	m.	raincoat, waterproof (coat)
i jeans	n.		jeans
il laccio	n.		(shoe)lace
la lana	n.		wool
lungo	adj.		long
la macchia	n.		stain, mark, spot
la macchina da cucire			sewing machine
la maglietta	n.		T-shirt/tee-shirt; vest
il maglione	n.		sweater, pullover, jumper
la manica	n.		sleeve
marrone	adj.	inv.	brown
morbido	adj.		soft, smooth
le mutande	n.		(under)pants
le mutandine	n.		knickers
nero	adj.		black
nudo	adj.		naked, bare, nude
gli occhiali	n.		glasses, spectacles
gli occhiali da sole			sunglasses
l'ombrello	n.	m.	umbrella
l'orecchino	n.	m.	earring
d'oro			(made) of gold, gold
l'orologio (da polso)	n.	m.	(wrist)watch
il panciotto	n.		waistcoat
i pantaloni	n.		trousers
la pantofola	n.		slipper
il pigiama	n.		(pair of) pyjamas
il portafoglio	n.		wallet; briefcase
il profumo	n.		perfume, scent
rammendare	v.		to mend, to repair; to darn
il reggiseno	n.		bra
rosa	adj.	inv.	pink
il rossetto	n.		lipstick; rouge
rosso	adj.		red
rozzo	adj.		rough, coarse
il sandalo	n.		sandal
il satin	n.		satin
sbottonare	v.		to unbutton, to undo
la scarpa	n.		shoe
le scarpe da ginnastica			gym shoes, trainers
la sciarpa	n.		scarf
sciatto	adj.		scruffy, slovenly, unkempt
la seta	n.		silk
spesso	adj.		thick
lo spillo	n.		pin
spogliarsi	v.		to undress (oneself), to get undressed
stare bene (a)			to fit; to suit
lo stivale	n.		boot
strappare	v.		to tear, to rip
stretto	adj.		tight(-fitting)
il tacco a spillo			stiletto heel
la taglia	n.		size
la tasca	n.		pocket
il tessuto	n.		cloth, fabric, material
tingere	v.		to dye
togliere	v.		to take off, to remove
il trucco	n.		make-up
l'uniforme	n.	f.	uniform
il velluto	n.		velvet
il velo	n.		veil
verde	adj.		green
vestirsi	v.		to dress (oneself), to get dressed
i vestiti	n.		clothes
il vestito (da donna)	n.		(woman's) dress
viola	adj.	inv.	purple, violet