австрал'ийский	adj.		Australian
Австр'алия (-и)	n.		Australia
австр'ийский	adj.		Austrian
'Австрия (-и)	n.		Austria
авт'обус (-а)	n.		bus
'Азия (-и)	n.		Asia
америк'анский	adj.		American
англ'ийский	adj.		English
'Англия (-и)	n.		England
Атлант'ический оке'ан			Atlantic (Ocean)
'Африка (-и)	n.		Africa
аэроп'орт (-а)	n.		airport
баг'аж (-'а)	n.		luggage, baggage
Балт'ийское м'оре			Baltic (Sea)
бельг'ийский	adj.		Belgian
Б'ельгия (-и)	n.		Belgium
бенз'ин (-а)	n.		petrol
бил'ет (-а)	n.		ticket
Браз'илия (-и)	n.		Brazil
вал'юта (-ы)	n.		(foreign/hard) currency
велосип'ед (-а)	n.		bicycle, bike
венг'ерский	adj.		Hungarian
В'енгрия (-и)	n.		Hungary
взлет'ать/взлет'еть	v.		to take off, to leave the ground
в'иза (-ы)	n.		visa
вокз'ал (-а)	n.		(railway/train) station
вост'ок (-а)	n.		(the) east
Герм'ания (-и)	n.		Germany
говор'ить по-р'усски		impf.	to speak Russian
Голл'андия (-и)	n.		Holland
голл'андский	adj.		Dutch
г'ород (-а)	n.		town; city
гост'иница (-ы)	n.		hotel
гран'ица (-ы)	n.		border, frontier
Гр'еция (-и)	n.		Greece
гр'еческий	adj.		Greek
Д'ания (-и)	n.		Denmark
д'атский	adj.		Danish
Евр'опа (-ы)	n.		Europe
Ег'ипет (-а)	n.		Egypt
'ехать/по'ехать за гран'ицу			to go abroad
жел'езная доро'га			railway
загор'ать/загор'еть	v.		to get (sun)burnt; to get a (sun)tan
загор'елый	adj.		sunburnt; tanned, brown, bronzed
з'апад (-а)	n.		(the) west
инд'ийский	adj.		Indian
Инд'ийский оке'ан			Indian Ocean
'Индия (-и)	n.		India
иностр'анец (-нца)	n.		foreigner
иностр'анный	adj.		foreign
Ирл'андия (-и)	n.		Ireland
ирл'андский	adj.		Irish
Исп'ания (-и)	n.		Spain
исп'анский	adj.		Spanish
Ит'алия (-и)	n.		Italy
италь'янский	adj.		Italian
Кан'ада (-ы)	n.		Canada
кан'адский	adj.		Canadian
кан'икулы (-)	n.	pl.	(school) holidays, vacation
к'арта (-ы)	n.		map
Кит'ай (-я)	n.		China
кит'айский	adj.		Chinese
кор'абль (-'я)	n.		ship
лёгкий	adj.		light
маш'ина (-ы)	n.		car
М'ексика (-и)	n.		Mexico
мотоц'икл (-а)	n.		motorcycle, motorbike
направл'ение (-я)	n.		direction
нем'ецкий	adj.		German
Нидерл'анды (-ов)	n.	pl.	(the) Netherlands
Н'овая Зел'андия			New Zealand
н'омер (-а)	n.		(hotel) room
Норв'егия (-и)	n.		Norway
норв'ежский	adj.		Norwegian
отдых'ать	v.	impf.	to be on holiday; to rest, to be resting
откр'ытка (-и)	n.		postcard
отправл'яться/отпр'авиться	v.		to set off/out, to leave, to depart
'отпуск (-а)	n.		leave, holiday(s)
пал'атка (-и)	n.		tent
п'аспорт (-а)	n.		passport
пляж (-а)	n.		beach
п'оезд (-а)	n.		train
по'ездка (-и)	n.		(short) journey; trip, excursion, outing, tour
п'ольский	adj.		Polish
П'ольша (-и)	n.		Poland
поним'ать/пон'ять	v.		to understand
порт (-а)	n.		port; harbour
Португ'алия (-и)	n.		Portugal
португ'альский	adj.		Portuguese
прибыв'ать/приб'ыть	v.		to arrive
приземл'яться/приземл'иться	v.		to land, to touch down
провож'ать/провод'ить	v.		to see off, to accompany
путеш'ествие (-я)	n.		journey, voyage
путеш'ествовать	v.	impf.	to travel
Росс'ия (-и)	n.		Russia
р'усский	adj.		Russian
рюкз'ак (-'а)	n.		rucksack, backpack
сад'иться/сесть (на что)	v.		to get on, to board; to embark
самолёт (-а)	n.		(aero)plane
с'евер (-а)	n.		(the) north
С'еверная Ам'ерика			North America
С'еверное м'оре			North Sea
С'еверный Ледов'итый оке'ан			Arctic Ocean
С'еверный п'олюс			North Pole
скуч'ать (по ком'у/чем'у)	v.	impf.	to miss, to long/yearn (for)
Соединённое Корол'евство			(the) United Kingdom
Соединённые Шт'аты			(the) United States
спас'ательная к'уртка			life-jacket
Средиз'емное м'оре			Mediterranean (Sea)
стран'а (-'ы)	n.		country
стр'анный	adj.		strange, odd
сход'ить/сойт'и (с чег'о)	v.		to get off, to alight (from)
такс'и	n.	nt. indecl.	taxi
Т'ихий оке'ан			Pacific (Ocean)
трамв'ай (-я)	n.		tram; tramline
троп'ический	adj.		tropical
тур'ецкий	adj.		Turkish
тур'изм (-а)	n.		tourism
Т'урция (-и)	n.		Turkey
тяжёлый	adj.		heavy
У'эльс (-а)	n.		Wales
у'эльский	adj.		Welsh
Фр'анция (-и)	n.		France
франц'узский	adj.		French
чемод'ан (-а)	n.		suitcase
Чёрное м'оре			Black Sea
шв'едский	adj.		Swedish
Швейц'ария (-и)	n.		Switzerland
швейц'арский	adj.		Swiss
Шв'еция (-и)	n.		Sweden
Шотл'андия (-и)	n.		Scotland
шотл'андский	adj.		Scottish
экв'атор (-а)	n.		equator
экзот'ический	adj.		exotic
юг (-а)	n.		(the) south
'Южная Ам'ерика			South America
'Южная 'Африка			South Africa
'Южный оке'ан			Antarctic Ocean
'Южный п'олюс			South Pole
Яп'ония (-и)	n.		Japan
яп'онский	adj.		Japanese
атл'ас (-а)	n.		satin
б'архат (-а)	n.		velvet
б'елый	adj.		white
бельё (-'я)	n.		underwear
бл'узка (-и)	n.		blouse
бот'инок (-нка)	n.		boot
брасл'ет (-а)	n.		bracelet
бр'юки (-)	n.	pl.	trousers
бул'авка (-и)	n.		pin
бум'ажник (-а)	n.		wallet
воротн'ик (-'а)	n.		collar
ву'аль (-и)	n.		veil
г'алстук (-а)	n.		tie
голуб'ой	adj.		(light/pale) blue
г'олый	adj.		naked, bare, nude
гр'убый	adj.		coarse, rough
губн'ая пом'ада			lipstick
д'амское бельё			lingerie, women's underwear
дж'инсы (-ов)	n.	pl.	jeans
дл'инный	adj.		long
дух'и (-'ов)	n.	pl.	perfume, scent
жёлтый	adj.		yellow
жил'ет (-а)	n.		waistcoat
зав'язывать/завяз'ать	v.		to tie, to knot
застёгивать/застегн'уть	v.		to fasten, to do up, to button (up)
зелёный	adj.		green
золот'истый	adj.		gold (in colour), golden
золот'ой	adj.		gold, (made) of gold
з'онтик (-а)	n.		umbrella
игл'а (-'ы)	n.		needle
изн'ашивать/износ'ить	v.		to wear out
карм'ан (-а)	n.		pocket
к'ожа (-и)	n.		leather
колг'отки (-ток)	n.	pl.	tights
кольц'о (-'а)	n.		ring
кор'ичневый	adj.		brown
кор'откий	adj.		short
кост'юм (-а)	n.		suit
кошелёк (-льк'а)	n.		purse
кр'асить/покр'асить	v.		to dye
кр'асный	adj.		red
кросс'овки (-вок)	n.	pl.	trainers, running shoes
куп'альный кост'юм			swimming/bathing costume, swimsuit
к'уртка (-и)	n.		jacket
л'ифчик (-а)	n.		bra
м'айка (-и)	n.		T-shirt/tee-shirt; vest
мех (-а)	n.		fur
м'одный	adj.		fashionable, stylish
м'ягкий	adj.		soft
надев'ать/над'еть	v.		to put on
нейл'он (-а)	n.		nylon
н'итка (-и)	n.		thread
носов'ой плат'ок			handkerchief
нос'ок (-ск'а)	n.		sock
ночн'ая сор'очка			nightdress, nightie
'обувь (-и)	n.		footwear
одев'аться/од'еться	v.		to dress (oneself), to get dressed
од'ежда (-ы)	n.		clothes, clothing
ор'анжевый	adj.		orange
очк'и (-'ов)	n.	pl.	glasses, spectacles
пальт'о	n.	nt. indecl.	(over)coat
переодев'аться/переод'еться	v.		to change (one's clothes), to get changed
перч'атка (-и)	n.		glove
пиж'ама (-ы)	n.		(pair of) pyjamas
пл'авки (-вок)	n.	pl.	swimming trunks
пл'атье (-я)	n.		(woman's) dress
плащ (-'а)	n.		raincoat, waterproof (coat)
подкл'адка (-и)	n.		lining
портф'ель (-я)	n.		briefcase
прост'орный	adj.		loose(-fitting), ample
п'уговица (-ы)	n.		button
пул'овер (-а)	n.		pullover
пурп'урный	adj.		purple
пятн'о (-'а)	n.		stain, mark, spot
разв'язывать/развяз'ать	v.		to untie, to undo
раздев'аться/разд'еться	v.		to undress (oneself), to get undressed
разм'ер (-а)	n.		size, measurement(s)
расстёгивать/расстегн'уть	v.		to unfasten, to undo, to unbutton
рвать	v.	impf.	to tear, to rip
рем'ень (-мн'я)	n.		strap; belt
р'озовый	adj.		pink
руб'ашка (-и)	n.		shirt
рук'ав (-'а)	n.		sleeve
санд'алия (-и)	n.		sandal
серебр'истый	adj.		silver (in colour), silvery
сер'ебряный	adj.		silver, (made) of silver
с'ерый	adj.		grey
серьг'а (-'и)	n.		earring
с'иний	adj.		blue
сним'ать/снять	v.		to take off, to remove
солнцезащ'итные очк'и			sunglasses
сп'ица (-ы)	n.		knitting needle
т'есный	adj.		tight(-fitting)
ткань (-и)	n.		fabric, cloth, material
трус'ы (-'ов)	n.	pl.	underpants; knickers
т'уфля (-и)	n.		shoe; slipper
фиол'етовый	adj.		violet
футб'олка (-и)	n.		sweatshirt
хл'опок (-пка)	n.		cotton
хорош'о сид'еть (на ком)		impf.	to fit (well), to be a good fit
цвет (-а)	n.		colour
цеп'очка (-и)	n.		necklace, chain
чёрный	adj.		black
чин'ить/почин'ить	v.		to mend, to repair
чул'ок (-лк'а)	n.		stocking
шарф (-а)	n.		scarf
шв'ейная маш'ина			sewing machine
шёлк (-а)	n.		silk
шерсть (-и)	n.		wool
шить/сшить	v.		to sew
шл'япа (-ы)	n.		hat
шнур'ок (-рк'а)	n.		(shoe)lace
ш'орты (-)	n.	pl.	shorts
ш'уба (-ы)	n.		fur coat
элег'антный	adj.		elegant
'юбка (-и)	n.		skirt
ювел'ирные изд'елия			jewellery
абз'ац (-а)	n.		paragraph
атл'етика (-и)	n.		athletics
аттест'ат зр'елости			school-leaving certificate
биол'огия (-и)	n.		biology
вест'и себ'я пл'охо		impf.	to misbehave, to behave badly
вест'и себ'я хорош'о		impf.	to behave (well), to behave oneself
веч'ерние к'урсы			evening classes
вним'ательный	adj.		attentive
вопр'ос (-а)	n.		question
вопрос'ительный знак			question mark
восклиц'ательный знак			exclamation mark
воспит'ание (-я)	n.		upbringing; education
вступ'ительный экз'амен			entrance exam
вычёркивать/в'ычеркнуть	v.		to cross out; to erase
вычисл'ительная т'ехника			computer science, information technology
геогр'афия (-и)	n.		geography
гот'овиться к экз'амену		impf.	to prepare/revise for an exam
грамм'атика (-и)	n.		grammar
двоет'очие (-я)	n.		colon
д'етский сад			nursery school, kindergarten
дикт'ант (-а)	n.		dictation
дипл'ом (-а)	n.		diploma, degree
дир'ектор шк'олы			headteacher, headmaster/headmistress
дом'ашнее зад'ание			(piece of) homework
доск'а (-'и)	n.		blackboard
забыв'ать/заб'ыть	v.		to forget
задав'ать/зад'ать вопр'ос			to ask a question
за'очный курс	n.		correspondence course
запят'ая (-'ой)	n.		comma
зн'ание (-я)	n.		knowledge
знать	v.	impf.	to know
изуч'ать	v.	impf.	to study, to learn
интер'есный	adj.		interesting
иск'усство (-а)	n.		art
ист'ория (-и)	n.		history
каранд'аш (-'а)	n.		pencil
кл'ассная к'омната			classroom
компь'ютер (-а)	n.		computer
контр'ольная раб'ота			test
л'екция (-и)	n.		lecture
лен'ивый	adj.		lazy
лин'ейка (-и)	n.		ruler
матем'атика (-и)	n.		mathematics, maths
мел (-а)	n.		chalk
м'узыка (-и)	n.		music
непр'авильный	adj.		wrong, incorrect
образов'ание (-я)	n.		education
образ'ованный	adj.		(well-)educated
ок'анчивать/ок'ончить университ'ет			to graduate
ок'анчивать/ок'ончить шк'олу			to leave school
отв'ет (-а)	n.		answer, reply, response
отвеч'ать/отв'етить (на что)	v.		to answer, to reply/respond (to)
отм'етка (-и)	n.		mark, grade
ош'ибка	n.		mistake, error
перем'ена (-ы)	n.		break
переп'исывать/перепис'ать	v.		to copy (out), to rewrite
пис'ать/напис'ать	v.		to write
повтор'ять/повтор'ить	v.		to repeat
подчёркивать/подчеркн'уть	v.		to underline
полит'ические на'уки			political science, politics
п'омнить	v.	impf.	to remember
поним'ать/пон'ять	v.		to understand
посл'ушный	adj.		obedient
пр'авильный	adj.		right, correct
предлож'ение (-я)	n.		sentence; clause
предм'ет (-а)	n.		(school) subject
преподав'атель (-я)	n.		lecturer, (university) teacher
прим'ер (-а)	n.		example
провал'иться на экз'амене		pf.	to fail an exam
прост'ой	adj.		simple; easy
психол'огия (-и)	n.		psychology
пункту'ация (-и)	n.		punctuation
распис'ание (-я)	n.		timetable
рез'инка (-и)	n.		rubber, eraser
результ'ат (-а)	n.		result
р'усская литерат'ура			Russian literature
р'усский яз'ык			Russian language
р'учка (-и)	n.		pen
сдав'ать экз'амен		impf.	to take/sit an exam
сдать экз'амен		pf.	to pass an exam
ск'учный	adj.		boring, tedious, dull
слов'арь (-'я)	n.		dictionary
сл'ожный	adj.		complicated, complex
сл'ушать/просл'ушать л'екцию			to attend a lecture
социол'огия (-и)	n.		sociology
сочин'ение (-я)	n.		composition, essay
спр'ашивать/спрос'ить	v.		to ask, to inquire
стран'ица (-ы)	n.		page
студ'ент (-а)	n.		(male) student
тал'антливый	adj.		talented, gifted
т'ема (-ы)	n.		subject, topic, theme
теол'огия (-и)	n.		theology
тетр'адь (-и)	n.		exercise book
т'очка (-и)	n.		full stop; point; dot
т'очка с запят'ой			semicolon
т'очный	adj.		exact, precise, accurate
тр'ебовать/потр'ебовать	v.		to demand, to request, to require
тр'удный	adj.		difficult, hard
трудолюб'ивый	adj.		hard-working, industrious, diligent
ук'азывать/указ'ать (на что)	v.		to point (at/to)
университ'ет (-а)	n.		university
упражн'ение (-я)	n.		exercise
ур'ок (-а)	n.		lesson
уч'ебник (-а)	n.		textbook
уч'ебный план			curriculum, syllabus
учен'ик (-'а)	n.		(male) pupil
уч'итель (-я)	n.		(male) teacher
уч'ить/науч'ить	v.		to teach
ф'изика (-и)	n.		physics
физкульт'ура (-ы)	n.		physical education, PE
филос'офия (-и)	n.		philosophy
х'имия (-и)	n.		chemistry
чит'ать/прочит'ать	v.		to read
шк'ола (-ы)	n.		school
шк'ольная ф'орма			school uniform
шк'ольник (-а)	n.		schoolboy
шк'ольница (-ы)	n.		schoolgirl
экон'омика (-и)	n.		economics
элемент'арный	adj.		elementary
абрик'ос (-а)	n.		apricot
анан'ас	n.		pineapple
апельс'ин (-а)	n.		orange
арб'уз (-а)	n.		watermelon
баклаж'ан (-а)	n.		aubergine
бан'ан (-а)	n.		banana
б'анка (-и)	n.		jar; tin, can
бар'анина (-ы)	n.		mutton, lamb
бифшт'екс (-а)	n.		(beef)steak
бл'юдо (-а)	n.		dish; course
бл'юдце (-а)	n.		saucer
бутербр'од (-а)	n.		(piece of) bread and butter, sandwich
вар'енье (-я)	n.		jam
вар'ить/свар'ить	v.		to boil, to cook
ветчин'а (-'ы)	n.		ham
в'илка (-и)	n.		fork
вин'о (-'а)	n.		wine
виногр'ад (-а)	n.		grapes
вк'усный	adj.		nice, tasty
гов'ядина (-ы)	n.		beef
гор'ох (-а)	n.		pea; peas
горч'ица (-ы)	n.		mustard
г'орький	adj.		bitter
гор'ячий	adj.		hot
гот'овить	v.	impf.	to prepare, to cook
гр'ейпфрут (-а)	n.		grapefruit
гриб (-'а)	n.		mushroom
гр'уша (-и)	n.		pear
дес'ерт (-а)	n.		dessert
д'ыня (-и)	n.		melon
ежев'ика (-и)	n.		blackberries
есть/съесть	v.		to eat
ж'арить/заж'арить	v.		to roast; to fry; to grill
з'автрак (-а)	n.		breakfast
з'автракать/поз'автракать	v.		to (have) breakfast
зак'азывать/заказ'ать	v.		to order; to reserve, to book
замор'оженный	adj.		frozen
из'юм (-а)	n.		raisins
кап'уста (-ы)	n.		cabbage
карт'офель (-я)	n.		potatoes
кастр'юля (-и)	n.		(sauce)pan
к'ислый	adj.		sour
клубн'ика (-и)	n.		strawberries
колбас'а (-'ы)	n.		(large/slicing) sausage
к'офе	n.	m. indecl.	coffee
кр'епкий	adj.		strong
кр'ужка (-и)	n.		mug
кукур'уза (-ы)	n.		maize, sweetcorn
к'урица (-ы)	n.		chicken
лим'он (-а)	n.		lemon
лимон'ад (-а)	n.		lemonade
л'ожка (-и)	n.		spoon
лук (-а)	n.		onions
мал'ина (-ы)	n.		raspberries
м'асло (-а)	n.		butter; oil
мёд (-а)	n.		honey
мен'ю	n.	nt. indecl.	menu
м'иска (-и)	n.		bowl, basin
молок'о (-'а)	n.		milk
морк'овь (-и)	n.		carrots
мук'а (-'и)	n.		flour
мыть/в'ымыть пос'уду			to wash up, to do the washing-up/dishes
м'ясо (-а)	n.		meat
накрыв'ать/накр'ыть (на) стол			to set/lay the table
налив'ать/нал'ить	v.		to pour (out)
нап'иток (-тка)	n.		drink, beverage
нож (-'а)	n.		knife
об'ед (-а)	n.		dinner, lunch, midday meal
об'едать/пооб'едать	v.		to have lunch/dinner, to dine
'овощи (-'ей)	n.	pl.	vegetables
огур'ец (-рц'а)	n.		cucumber
ор'ех (-а)	n.		nut
'острый	adj.		hot, spicy, strong, piquant
п'ахнуть (чем)	v.	impf.	to smell (of)
п'ерец (-рца)	n.		pepper
п'ерсик (-а)	n.		peach
печь/исп'ечь	v.		to bake
п'иво (-а)	n.		beer
пир'ог (-'а)	n.		pie; tart
пить/в'ыпить	v.		to drink
п'ища (-и)	n.		food
помид'ор (-а)	n.		tomato
припр'ава (-ы)	n.		seasoning; relish, condiment
пр'обовать/попр'обовать	v.		to try, to taste, to sample
пшен'ица (-ы)	n.		wheat
рис (-а)	n.		rice
р'ыба (-ы)	n.		fish
сал'ат (-а)	n.		lettuce; salad
с'ахар (-а)	n.		sugar
св'ежий	adj.		fresh
свёкла (-и)	n.		beetroot
свин'ина (-ы)	n.		pork
сельдер'ей (-я)	n.		celery
с'идр (-а)	n.		cider
сковор'одка (-и)	n.		frying pan
сл'абый	adj.		weak
сл'адкий	adj.		sweet
сл'ива (-ы)	n.		plum
сл'ивки (-вок)	n.	pl.	cream
сок (-а)	n.		juice
солёный	adj.		salty; salted; pickled
соль (-и)	n.		salt
с'оус (-а)	n.		sauce; gravy; dressing
сп'еции (-й)	n.	pl.	spice(s)
стак'ан (-а)	n.		glass, tumbler
стол на дво'их			table for two
суп (-а)	n.		soup
счёт (-а)	n.		bill
сыр (-а)	n.		cheese
сыр'ой	adj.		raw, uncooked; green, unripe
тар'елка (-и)	n.		plate
торт (-а)	n.		cake
убир'ать/убр'ать со стол'а			to clear the table
'ужин (-а)	n.		dinner, supper, evening meal
'ужинать/по'ужинать	v.		to have dinner/supper, to dine
'уксус (-а)	n.		vinegar
фр'укт (-а)	n.		(piece of) fruit
хлеб (-а)	n.		bread
хот'еть есть		impf.	to be hungry
хот'еть пить		impf.	to be thirsty
цветн'ая кап'уста			cauliflower
чай (-я)	n.		tea
ч'ашка (-и)	n.		cup
чер'ешня (-и)	n.		cherry; cherries
чёрная смор'одина			blackcurrants
чесн'ок (-'а)	n.		garlic
шпин'ат (-а)	n.		spinach
'яблоко (-а)	n.		apple
яйц'о (-'а)	n.		egg
'астма (-ы)	n.		asthma
бедр'о (-'а)	n.		thigh, hip
бер'еменная	adj.		pregnant
бинт (-'а)	n.		bandage
бл'едный	adj.		pale, pallid
бол'езнь (-и)	n.		illness, sickness; disease
болеутол'яющее ср'едство			painkiller
боль (-и)	n.		pain; ache
больн'ой	adj.		ill, sick, diseased
больш'ой п'алец			thumb
бровь (-и)	n.		eyebrow
бронх'ит (-а)	n.		bronchitis
брос'ать/бр'осить кур'ить			to give up smoking, to stop/quit smoking
в хор'ошей ф'орме			fit, in good shape
вис'ок (-ск'а)	n.		temple
в'олосы (вол'ос)	n.	pl.	hair
вр'едный	adj.		harmful, injurious (to health)
глаз (-а)	n.		eye
глух'ой	adj.		deaf
голов'а (-'ы)	n.		head
г'орло (-а)	n.		throat
грипп (-а)	n.		flu, influenza
грудь (-и)	n.		chest, breast; bosom, bust
губ'а (-'ы)	n.		lip
ди'агноз (-а)	n.		diagnosis
д'оза (-ы)	n.		dose
дыш'ать	v.	impf.	to breathe
жел'удок (-дка)	n.		stomach
жив'от (-а)	n.		belly, tummy; stomach
заболев'ать/забол'еть (чем)	v.		to fall ill (with), to be taken ill (with)
запл'акать	v.	pf.	to start/begin to cry, to start crying
зап'ястье (-я)	n.		wrist
зар'азный	adj.		infectious; contagious
здор'овый	adj.		healthy
здор'овье (-я)	n.		health
зуб (-а)	n.		tooth
инс'ульт (-а)	n.		stroke
к'ожа (-и)	n.		skin
кост'ыль (-'я)	n.		crutch
кость (-и)	n.		bone
кровь (-и)	n.		blood
кур'ить/покур'ить	v.		to smoke
лёгкое (-ого)	n.		lung
лек'арство (-а)	n.		medicine, drug
лек'арство от к'ашля			cough medicine
леч'ение (-я)	n.		(medical) treatment
лиц'о (-'а)	n.		face
лоб (лба)	n.		forehead, brow
л'окоть (-ктя)	n.		elbow
лом'ать/слом'ать н'огу			to break one's leg
маш'ина ск'орой п'омощи			ambulance
медиц'ина (-ы)	n.		medicine, medical science
мозг (-а)	n.		brain; nerve tissue
нар'ыв (-а)	n.		abscess, boil
н'асморк (-а)	n.		(head) cold
неизлеч'имая бол'езнь			incurable illness/disease
ног'а (-'и)	n.		foot; leg
н'оготь (-гтя)	n.		(finger/toe)nail
нос (-а)	n.		nose
опер'ация (-и)	n.		operation
отдых'ать/отдохн'уть	v.		to (have a) rest
отр'ава (-ы)	n.		poison
п'адать/уп'асть в 'обморок			to faint, to swoon
п'алец (-льца)	n.		finger
п'алец ног'и			toe
пах (-а)	n.		groin
паци'ент (-а)	n.		(male) patient
п'еревязь (-и)	n.		sling
перел'ом (-а)	n.		break, fracture
п'ечень (-и)	n.		liver
пл'астырь (-я)	n.		(sticking) plaster
плеч'о (-'а)	n.		shoulder
поб'очное д'ействие			side-effect
подбор'одок (-дка)	n.		chin
позвон'очник (-а)	n.		spine, backbone, spinal column
полов'ые 'органы			genitals, sex(ual) organs
пор'ез (-а)	n.		cut
пор'езаться	v.	pf.	to cut oneself
пот (-а)	n.		sweat, perspiration
п'очка (-и)	n.		kidney
презерват'ив (-а)	n.		condom
приним'ать/прин'ять лек'арство			to take (some) medicine
прост'уда (-ы)	n.		(chest) cold
простуж'аться/простуд'иться	v.		to catch/get a cold
противозач'аточная пил'юля			contraceptive pill
прыщ (-'а)	n.		spot, pimple
пульс (-а)	n.		pulse
п'ятка (-и)	n.		heel
рак (-а)	n.		cancer
рентг'ен (-а)	n.		X-ray
ресн'ица (-ы)	n.		eyelash
рец'епт (-а)	n.		prescription
рот (рта)	n.		mouth
рук'а (-'и)	n.		hand; arm
серд'ечный пр'иступ			heart attack
с'ердце (-а)	n.		heart
син'як (-'а)	n.		bruise
скел'ет (-а)	n.		skeleton
сл'абый	adj.		weak, feeble
слеп'ой	adj.		blind
снотв'орная табл'етка			sleeping tablet/pill
сов'етоваться/посов'етоваться с врач'ом			to consult a doctor
с'олнечный уд'ар			sunstroke
спин'а (-'ы)	n.		back
ср'едство (-а)	n.		remedy, cure
страд'ать (от чег'о)	v.	impf.	to suffer (from)
сыпь (-и)	n.		rash, (skin) eruption
табл'етка (-и)	n.		tablet, pill
т'алия (-и)	n.		waist
т'ело (-а)	n.		body
терм'ометр (-а)	n.		thermometer
у мен'я бол'ит голов'а			I have a headache
у мен'я бол'ит г'орло			I have a sore throat
у мен'я бол'ит зуб			I have (a) toothache
умир'ать/умер'еть	v.		to die
ус'ы (-'ов)	n.	pl.	moustache
утеш'ать/утеш'ить	v.		to comfort, to console
'ухо (-а)	n.		ear
хирург'ия (-и)	n.		surgery
ч'елюсть (-и)	n.		jaw(-bone)
ч'ереп (-а)	n.		skull
ч'увствовать себ'я хорош'о		impf.	to feel well/good
ш'ея (-и)	n.		neck
шприц (-а)	n.		syringe
шрам (-а)	n.		scar
щек'а (-'и)	n.		cheek
эпид'емия (-и)	n.		epidemic
'язва (-ы)	n.		ulcer
яз'ык (-'а)	n.		tongue
балк'он (-а)	n.		balcony
бр'иться/побр'иться	v.		to (have a) shave
буд'ильник (-а)	n.		alarm clock
в'аза (-ы)	n.		vase
в'анна (-ы)	n.		bath(tub)
в'анная (-ой)	n.		bathroom
ведр'о (-'а)	n.		bucket
в'ешать/пов'есить бельё			to hang out/up the washing/laundry
видеомагнитоф'он (-а)	n.		video (cassette) recorder, video
включ'ать/включ'ить	v.		to turn/switch on; to plug in
встав'ать/встать	v.		to get up, to rise
выключ'атель (-я)	n.		switch
выключ'ать/в'ыключить	v.		to turn/switch off; to unplug
вытир'ать/в'ытереть	v.		to wipe (clean); to (rub) dry
газ'он (-а)	n.		lawn
гар'аж (-'а)	n.		garage
гардер'об (-а)	n.		wardrobe
гл'адить/погл'адить	v.		to iron, to press
гост'иная (-ой)	n.		living/sitting room, lounge
гр'язный	adj.		muddy; dirty, filthy
грязь (-и)	n.		mud; dirt, filth
дверь (-и)	n.		door
дом (-а)	n.		house; block of flats
д'ома			at home
дух'овка (-и)	n.		oven
душ (-а)	n.		shower
заб'ор (-а)	n.		fence
задёргивать/задёрнуть занав'ески			to close/draw the curtains
закрыв'ать/закр'ыть	v.		to close, to shut
зам'ок (-мк'а)	n.		lock
занав'еска (-и)	n.		curtain
засып'ать/засн'уть	v.		to go to sleep; to fall asleep
з'еркало (-а)	n.		mirror
кабин'ет (-а)	n.		study
кам'ин (-а)	n.		fireplace
карт'ина (-ы)	n.		picture
кварт'ира (-ы)	n.		flat, apartment
ключ (-'а)	n.		key
кн'ижный шкаф			bookcase
ковёр (-вр'а)	n.		carpet, rug, mat
к'омната (-ы)	n.		room
ком'од (-а)	n.		chest of drawers
кр'асить/покр'асить	v.		to paint
кр'есло (-а)	n.		armchair
кров'ать (-и)	n.		bed
кр'ыша (-и)	n.		roof
к'ухня (-и)	n.		kitchen
л'естница (-ы)	n.		stairs, staircase; ladder
лож'иться/лечь	v.		to lie down
лож'иться/лечь спать			to go to bed
магнитоф'он (-а)	n.		tape recorder, cassette recorder/player
м'ебель (-и)	n.		furniture
метл'а (-'ы)	n.		broom, brush
микров'олновая печь			microwave (oven)
мороз'ильник (-а)	n.		freezer
м'усорный 'ящик			(rubbish) bin, dustbin
м'ыло (-а)	n.		soap
м'ыться/в'ымыться	v.		to wash (oneself), to have a wash
на 'улице			outside, outdoors
нагрев'атель (-я)	n.		heater
н'ожницы (-)	n.	pl.	scissors
об'ои (-ев)	n.	pl.	wallpaper
оде'яло (-а)	n.		blanket
окн'о (-'а)	n.		window
отдёргивать/отдёрнуть занав'ески			to open/draw the curtains
открыв'ать/откр'ыть	v.		to open
п'исьменный стол			(writing) desk
плит'а (-'ы)	n.		cooker, stove
подок'онник (-а)	n.		window sill/ledge
под'ушка (-и)	n.		pillow; cushion
пол (-а)	n.		floor
п'олка (-и)	n.		shelf
полот'енце (-а)	n.		towel
посудом'оечная маш'ина			dishwasher
потол'ок (-лк'а)	n.		ceiling
приним'ать/прин'ять в'анну			to have/take a bath
приним'ать/прин'ять душ			to have/take a shower
причёсываться/причес'аться	v.		to do/brush/comb one's hair
про'игрыватель комп'акт-д'исков			CD-player
прост'орный	adj.		spacious, roomy
простын'я (-'и)	n.		sheet
просып'аться/просн'уться	v.		to wake (up)
пылес'ос (-а)	n.		vacuum cleaner, hoover
пылес'осить/пропылес'осить	v.		to vacuum, to hoover
пыль (-и)	n.		dust
п'ыльный	adj.		dusty
ради'атор (-а)	n.		radiator
р'адио	nt.	indecl.	radio
р'аковина (-ы)	n.		sink, washbasin
роз'етка (-и)	n.		(electric) socket, power point
сад (-а)	n.		garden
сад'иться/сесть	v.		to sit down
св'етлый	adj.		light, bright
сп'альня (-и)	n.		bedroom
стен'а (-'ы)	n.		wall
стир'альная маш'ина			washing machine
стир'ать/в'ыстирать бельё			to do the washing/laundry
стол (-'а)	n.		table
стол'овая (-ой)	n.		dining room
стр'оить/постр'оить	v.		to build
стул (-а)	n.		chair
телев'изор (-а)	n.		television (set)
телеф'он (-а)	n.		telephone
тёмный	adj.		dark
тр'япка (-и)	n.		cloth, rag; duster
туал'ет (-а)	n.		toilet
туал'етный ст'олик			dressing-table
убир'ать/убр'ать к'омнату			to tidy a/the room
убир'ать/убр'ать пост'ель			to make a/the bed
уд'обный	adj.		comfortable; convenient
ут'юг (-'а)	n.		iron
холод'ильник (-а)	n.		refrigerator, fridge
центр'альное отопл'ение			central heating
ч'истить/поч'истить з'убы			to clean/brush one's teeth
ч'истый	adj.		clean
шамп'унь (-я)	n.		shampoo
шкаф (-а)	n.		cupboard
шт'ора (-ы)	n.		blind
щётка (-и)	n.		brush
эт'аж (-'а)	n.		floor, storey
'ящик (-а)	n.		drawer
альпин'изм (-а)	n.		mountaineering, (mountain-)climbing
антр'акт (-а)	n.		interval
аплод'ировать (ком'у/чем'у)	v.	impf.	to applaud, to clap
аплодисм'енты (-ов)	n.	pl.	applause
атл'етика (-и)	n.		athletics
аудит'ория (-и)	n.		auditorium; audience
бал'ет (-а)	n.		ballet
бараб'ан (-а)	n.		drum
баскетб'ол (-а)	n.		basketball
бокс (-а)	n.		boxing
бол'ельщик (-а)	n.		fan, supporter
бубн'овый вал'ет			jack of diamonds
виолонч'ель (-и)	n.		cello
вы'игрывать/в'ыиграть	v.		to win
в'ыставка (-и)	n.		exhibition
газ'ета (-ы)	n.		newspaper
гимн'астика (-и)	n.		gymnastics
гит'ара (-ы)	n.		guitar
глав'а (-'ы)	n.		chapter
гоб'ой (-я)	n.		oboe
гольф (-а)	n.		golf
джаз (-а)	n.		jazz band; jazz (music)
документ'альный фильм			documentary (film)
дос'уг (-а)	n.		leisure(-time), spare/free time
ж'ивопись (-и)	n.		painting
журн'ал (-а)	n.		magazine; journal
забив'ать/заб'ить гол			to score a goal
зр'итель (-я)	n.		spectator
игр'а (-'ы)	n.		game
игр'ать в к'арты		impf.	to play cards
игр'ать в футб'ол		impf.	to play football
игр'ать в ш'ахматы		impf.	to play chess
игр'ать на гит'аре		impf.	to play the guitar
игр'ать на скрипке		impf.	to play the violin
игр'ать по сл'уху		impf.	to play by ear
игр'ать/сыгр'ать	v.		to play; to act
импровиз'ировать/сымпровиз'ировать	v.		to improvise
инструм'ент (-а)	n.		instrument
интересов'аться (чем)	v.	impf.	to be interested (in)
иск'усство (-а)	n.		art
кат'ание на коньк'ах			(ice-)skating
кат'ание на л'ыжах			skiing
кат'ание на р'оликах			roller-skating
кисть (-и)	n.		(paint)brush
кларн'ет (-а)	n.		clarinet
класс'ическая м'узыка			classical music
кн'ига (-и)	n.		book
кол'ода (-ы)	n.		pack/deck (of cards)
ком'анда (-ы)	n.		team
ком'едия (-и)	n.		comedy
конц'ерт (-а)	n.		concert, recital
кроссв'орд (-а)	n.		crossword
литерат'ура (-ы)	n.		literature
люб'имый	adj.		favourite
м'узыка (-и)	n.		music
мяч (-'а)	n.		ball
на дос'уге			in one's spare/free time
наст'ольный т'еннис			table-tennis
ничь'я (-'ей)	n.		draw, tie
но'вости (-'ей)	n.	pl.	news
'опера (-ы)	n.		opera
орк'естр (-а)	n.		orchestra; band
отл'ичный	adj.		excellent
п'арусный спорт			sailing
перед'ача (-и)	n.		broadcast; programme
п'есня (-и)	n.		song
петь/спеть	v.		to sing
пиан'ино	n.	nt. indecl.	(upright) piano
п'иковый туз			ace of spades
пл'авание (-я)	n.		swimming
поп-м'узыка (-и)	n.		pop music
портр'ет (-а)	n.		portrait
по'эзия (-и)	n.		poetry
представл'ение (-я)	n.		performance
при'ятный	adj.		pleasant, nice, agreeable, pleasing
про'игрывать/проигр'ать	v.		to lose, to be defeated
прям'ая перед'ача			live broadcast
пь'еса (-ы)	n.		(stage) play
радиост'анция (-и)	n.		radio station
развлек'ательный	adj.		entertaining
рак'етка (-и)	n.		racket/racquet, bat
расск'аз (-а)	n.		story, tale
репет'иция (-и)	n.		rehearsal
рец'ензия на кн'игу			book review
рисов'ание (-я)	n.		drawing
рисов'ать/нарисов'ать	v.		to draw, to paint
ром'ан (-а)	n.		novel; romance
ро'яль (-я)	n.		(grand) piano
саксоф'он (-а)	n.		saxophone
сентимент'альный	adj.		sentimental
скр'ипка (-и)	n.		violin
скульпт'ура (-ы)	n.		sculpture
сл'ушать/посл'ушать	v.		to listen (to)
смешн'ой	adj.		funny
смотр'еть/посмотр'еть (на ког'о/что)	v.		to look (at), to watch
соревнов'ание (-я)	n.		competition, contest, tournament
спорт (-а)	n.		sport(s)
стих'и (-'ов)	n.	pl.	verse(s), (lines of) poetry
стихотвор'ение (-я)	n.		poem
сц'ена (-ы)	n.		stage; scene
танцев'ать/станцев'ать	v.		to dance
т'еннис (-а)	n.		tennis
траг'едия (-и)	n.		tragedy
тр'ефовый кор'оль			king of clubs
тр'огательный	adj.		touching, moving
тромб'он (-а)	n.		trombone
труб'а (-'ы)	n.		trumpet
увлеч'ение (-я)	n.		passion, (favourite) hobby, (main) interest
фильм (-а)	n.		film, movie
фильм 'ужасов			horror film/movie
фл'ейта (-ы)	n.		flute
ф'окус (-а)	n.		(magic/conjuring) trick
фотоаппар'ат (-а)	n.		camera
футб'ол (-а)	n.		football
футб'ольный матч			football match
холст (-'а)	n.		canvas
хор (-а)	n.		choir
черв'онная д'ама			queen of hearts
чит'ать вслух		impf.	to read aloud
чит'ать/прочит'ать	v.		to read
ш'ахматы (-)	n.	pl.	chess
атмосф'ера (-ы)	n.		atmosphere
б'абочка (-и)	n.		butterfly
б'ерег (-а)	n.		shore, (river)bank
бол'ото (-а)	n.		marsh, bog, swamp
б'уря (-и)	n.		storm
ветвь (-и)	n.		branch, bough
в'етер (-тра)	n.		wind
в'етреный	adj.		windy
вл'ажный	adj.		humid, damp; moist
вод'а (-'ы)	n.		water
водоп'ад (-а)	n.		waterfall
в'оздух (-а)	n.		air
волк (-а)	n.		wolf
волн'а (-'ы)	n.		wave
всел'енная (-ой)	n.		universe
вулк'ан (-а)	n.		volcano
гал'актика (-и)	n.		galaxy
глуб'окий	adj.		deep
гнить/сгнить	v.		to rot, to decay, to decompose
гор'а (-'ы)	n.		mountain
гор'еть	v.	impf.	to burn, to be on fire
град (-а)	n.		hail
гроз'а (-'ы)	n.		(thunder)storm
гром (-а)	n.		thunder
д'ерево (-а)	n.		tree
дж'унгли (-ей)	n.	pl.	jungle
дождл'ивый	adj.		rainy, wet
дождь (-'я)	n.		rain
дол'ина (-ы)	n.		valley
д'ует в'етер			it's windy
дуть/под'уть	v.		to blow
д'ушный	adj.		close, sultry, stuffy
ест'ественный	adj.		natural
ж'арко			it's hot
жив'ой	adj.		living, live, alive
жив'отное (-ого)	n.		animal
загор'аться/загор'еться	v.		to catch fire, to begin/start to burn
зал'ив (-а)	n.		bay
звезд'а (-'ы)	n.		star
землетряс'ение (-я)	n.		earthquake
земл'я (-'и)	n.		earth, land, soil
зме'я (-'и)	n.		snake
идёт дождь			it's raining
идёт снег			it's snowing
'изморось (-и)	n.		drizzle
к'амень (-мня)	n.		stone
кл'имат (-а)	n.		climate
ком'ар (-'а)	n.		mosquito
контин'ент (-а)	n.		continent
к'орень (-рня)	n.		root
кор'ова (-ы)	n.		cow
к'ошка (-и)	n.		cat
крокод'ил (-а)	n.		crocodile
кр'олик (-а)	n.		rabbit
крут'ой	adj.		steep
к'урица (-ы)	n.		chicken, hen
куст (-'а)	n.		bush, shrub
лев (льва)	n.		lion
лёд (льда)	n.		ice
лес (-а)	n.		forest, wood(s)
лет'учая мышь			bat
л'ивень (-вня)	n.		(heavy) shower, downpour
лис'а (-'ы)	n.		fox
лист (-'а)	n.		leaf
л'ошадь (-и)	n.		horse
луг (-а)	n.		meadow
лун'а (-'ы)	n.		moon
медв'едь (-я)	n.		bear
мёртвый	adj.		dead
мет'ель (-и)	n.		snow-storm, blizzard
мир (-а)	n.		world
м'окрый	adj.		wet
м'олния (-и)	n.		lightning
м'оре (-я)	n.		sea
мор'оз (-а)	n.		frost
мурав'ей (-ь'я)	n.		ant
мышь (-и)	n.		mouse
наводн'ение (-я)	n.		flood
насек'омое (-ого)	n.		insect
н'ебо (-а)	n.		sky
'облако (-а)	n.		cloud
'облачно			it's cloudy
овц'а (-'ы)	n.		sheep
ог'онь (огн'я)	n.		fire
'озеро (-а)	n.		lake
оке'ан (-а)	n.		ocean
орёл (орл'а)	n.		eagle
ос'а (-'ы)	n.		wasp
осёл (осл'а)	n.		donkey, ass
'остров (-а)	n.		island
па'ук (-'а)	n.		spider
пес'ок (-ск'а)	n.		sand
план'ета (-ы)	n.		planet
плодор'одный	adj.		fertile
пог'ода (-ы)	n.		weather
п'оле (-я)	n.		field
полу'остров (-а)	n.		peninsula
п'очка (-и)	n.		bud
прир'ода (-ы)	n.		nature
пруд (-'а)	n.		pond
пт'ица (-ы)	n.		bird
пуст'ыня (-и)	n.		desert
пчел'а (-'ы)	n.		bee
р'адуга (-и)	n.		rainbow
размнож'аться/размн'ожиться	v.		to breed, to reproduce, to multiply
раст'ение (-я)	n.		plant
раст'и	v.	impf.	to grow
раст'ительность (-и)	n.		vegetation
рек'а (-'и)	n.		river
руч'ей (-'ья)	n.		stream, brook
р'ыба (-ы)	n.		fish
свет'ить	v.	impf.	to shine
свинь'я (-'и)	n.		pig
с'емя (-ени)	n.		seed
слон (-'а)	n.		elephant
снег (-а)	n.		snow
соб'ака (-и)	n.		dog
сов'а (-'ы)	n.		owl
с'олнечная сист'ема			solar system
с'олнце (-а)	n.		sun
с'олнце св'етит			it's sunny, the sun is shining
ствол (-'а)	n.		(tree) trunk
ст'ебель (-бля)	n.		stem, stalk
сугр'об (-а)	n.		snowdrift
сух'ой	adj.		dry
тарак'ан (-а)	n.		cockroach
тепл'о			it's warm
течь	v.	impf.	to flow
тигр (-а)	n.		tiger
трав'а (-'ы)	n.		grass
тум'ан (-а)	n.		fog, mist
т'уча (-и)	n.		(rain/storm) cloud
ул'итка (-и)	n.		snail
ураг'ан (-а)	n.		hurricane
холм (-'а)	n.		hill
х'олодно			it's cold
цвест'и	v.	impf.	to flower, to bloom, to blossom
цвет'ок (-тк'а)	n.		flower
червь (-'я)	n.		worm
'яркий	adj.		bright
'ясный	adj.		clear
агресс'ивный	adj.		aggressive
'адрес (-а)	n.		address
актёр (-а)	n.		actor
актр'иса (-ы)	n.		actress
архит'ектор (-а)	n.		architect
б'абушка (-и)	n.		grandmother
б'едный	adj.		poor
библиот'екарь (-я)	n.		librarian
бизнесм'ен (-а)	n.		businessman
близн'ец (-'а)	n.		twin
бог'атый	adj.		rich
брат (-а)	n.		brother
весёлый	adj.		cheerful, merry
взр'ослый	adj.		adult, grown-up
внук (-а)	n.		grandson
вн'учка (-и)	n.		granddaughter
водопров'одчик (-а)	n.		plumber
в'озраст (-а)	n.		age
врач (-'а)	n.		doctor
гл'упый	adj.		foolish, stupid, silly
г'ордый	adj.		proud
гр'устный	adj.		sad
д'ата рожд'ения			date of birth
д'евочка (-и)	n.		(little) girl
д'евушка (-и)	n.		girl, young woman
д'едушка (-и)	n.	m.	grandfather
д'етство (-а)	n.		childhood
диплом'ат (-а)	n.		diplomat
д'обрый	adj.		kind, good
довер'ять (ком'у)	v.	impf.	to trust
домохоз'яйка (-и)	n.		housewife
дочь (-ери)	n.		daughter
друг (-а)	n.		friend
др'ужеский	adj.		friendly
д'ядя (-и)	n.		uncle
жен'а (-'ы)	n.		wife
ж'енщина (-ы)	n.		woman
жест'окий	adj.		cruel, brutal
жизнь (-и)	n.		life
журнал'ист (-а)	n.		journalist
знак'омый (-ого)	n.		acquaintance
знамен'итый	adj.		famous, celebrated, well-known
зубн'ой врач			dentist
'имя (-ени)	n.	nt.	(first) name, forename
инжен'ер (-а)	n.		engineer
кинозвезд'а (-'ы)	n.		film/movie star
композ'итор (-а)	n.		composer
крас'ивый	adj.		beautiful, pretty; handsome
льстить/польст'ить (ком'у)	v.		to flatter
люб'ить	v.	impf.	to love; to like, to be fond (of)
м'альчик (-а)	n.		(little) boy
мал'яр (-'а)	n.		painter, decorator
мать (-ери)	n.		mother
м'ачеха (-и)	n.		stepmother
медсестр'а (-'ы)	n.		(female) nurse
милицион'ер (-а)	n.		policeman, militiaman
млад'енец (-нца)	n.		baby
молод'ой	adj.		young
м'удрый	adj.		wise
муж (-а)	n.		husband
мужч'ина (-ы)	n.		man
музык'ант (-а)	n.		musician
ненав'идеть	v.	impf.	to hate, to detest, to loathe
оскорбл'ять/оскорб'ить	v.		to insult, to offend
от'ец (отц'а)	n.		father
'отрочество (-а)	n.		adolescence
'отчим (-а)	n.		stepfather
офици'ант (-а)	n.		waiter
офици'антка (-и)	n.		waitress
п'адчерица (-ы)	n.		stepdaughter
парикм'ахер (-а)	n.		hairdresser
п'асынок (-нка)	n.		stepson
пев'ец (-вц'а)	n.		(male) singer
пев'ица (-ы)	n.		(female) singer
пил'от (-а)	n.		pilot
пис'атель (-я)	n.		writer, author
п'овар (-а)	n.		cook
пож'арник (-а)	n.		fireman, fire-fighter
п'охороны (похор'он)	n.	pl.	funeral
почталь'он (-а)	n.		postman
пр'едок (-дка)	n.		ancestor, forefather
презир'ать	v.	impf.	to despise, to hold in contempt
продав'ец (-вц'а)	n.		(male) shop/sales assistant
продавщ'ица (-ы)	n.		(female) shop/sales assistant
проф'ессия (-и)	n.		profession, occupation, trade
прощ'ать/прост'ить	v.		to forgive, to pardon, to excuse
ребёнок (-нка)	n.		child, infant
ревн'ивый	adj.		jealous
р'обкий	adj.		timid, shy
род'ители (-ей)	n.	pl.	parents
род'иться	v.	pf.	to be born
р'одственник (-а)	n.		relation, relative
рожд'ение (-я)	n.		birth
рыб'ак (-'а)	n.		fisherman
сад'овник (-а)	n.		gardener
самоув'еренный	adj.		(self-)confident
св'адьба (-ы)	n.		wedding, marriage (ceremony)
свёкор (-кра)	n.		father-in-law, husband's father
свекр'овь (-и)	n.		mother-in-law, husband's mother
секрет'арь (-'я)	n.		secretary
семь'я (-'и)	n.		family
сестр'а (-'ы)	n.		sister
с'ильный	adj.		strong
скр'омный	adj.		modest
сл'абый	adj.		weak
смерть (-и)	n.		death
солд'ат (-а)	n.		soldier
соч'увствовать (ком'у)	v.	impf.	to sympathize (with)
ст'арый	adj.		old
судь'я (-'и)	n.	m.	judge
счастл'ивый	adj.		happy; lucky, fortunate
сын (-а)	n.		son
такс'ист (-а)	n.		taxi-driver
тесть (-я)	n.		father-in-law, wife's father
тётя (-и)	n.		aunt, aunty/auntie
тёща (-и)	n.		mother-in-law, wife's mother
'умный	adj.		clever, intelligent
учёный (-ого)	n.		scholar, academic; scientist
фам'илия (-и)	n.		surname, last name
ф'ермер (-а)	n.		farmer
фот'ограф (-а)	n.		photographer
хвал'ить/похвал'ить	v.		to praise, to compliment
хир'ург (-а)	n.		surgeon
худ'ожник (-а)	n.		artist
челов'ек (-а)	n.		person
честолюб'ивый	adj.		ambitious
шахтёр (-а)	n.		miner
шпи'он (-а)	n.		spy
электромонтёр (-а)	n.		electrician
юр'ист (-а)	n.		lawyer
арест'овывать/арестов'ать	v.		to arrest
'армия (-и)	n.		army
банкр'отство (-а)	n.		bankruptcy
бастов'ать/забастов'ать	v.		to (go/be on) strike
безраб'отица (-ы)	n.		unemployment
большинств'о (-'а)	n.		majority
б'омба (-ы)	n.		bomb
бор'оться (с кем/чем)	v.	impf.	to wrestle/struggle/fight (with)
будд'изм (-а)	n.		Buddhism
будд'ист (-а)	n.		Buddhist
в'ажный	adj.		important
вандал'изм (-а)	n.		vandalism
в'ера (-ы)	n.		faith, belief
в'ерить/пов'ерить (во что)	v.		to believe (in)
вин'овный (в чём)	adj.		guilty (of)
во'енно-возд'ушные с'илы			air force
во'енно-морск'ой флот			navy
войн'а (-'ы)	n.		war
вторж'ение (-я)	n.		invasion
в'ыборы (-ов)	n.	pl.	election(s)
вымог'ательство (-а)	n.		extortion
голосов'ать/проголосов'ать (за ког'о/что)	v.		to vote (for)
гражд'анство (-а)	n.		citizenship, nationality
демокр'атия (-и)	n.		democracy
диктат'ура (-ы)	n.		dictatorship
допр'ашивать/допрос'ить	v.		to interrogate, to question
евр'ей (-я)	n.		(male) Jew
забаст'овка (-и)	n.		strike, walkout
зав'од (-а)	n.		factory
заключ'ать/заключ'ить в тюрьм'у			to put in prison, to imprison, to jail
заключённый (-ого)	n.		prisoner, convict
зак'он (-а)	n.		law
запрещ'ать/запрет'ить	v.		to prohibit, to forbid, to ban
захв'атывать/захват'ить власть			to seize power
избив'ать/изб'ить	v.		to beat (up)
изнас'илование (-я)	n.		rape
инду'изм (-а)	n.		Hinduism
инд'ус (-а)	n.		Hindu
инфл'яция (-и)	n.		inflation
исл'ам (-а)	n.		Islam
иуда'изм (-а)	n.		Judaism
капитал'изм (-а)	n.		capitalism
коммун'изм (-а)	n.		communism
контр'акт (-а)	n.		contract
корол'ева (-ы)	n.		queen
кор'оль (-'я)	n.		king
кр'ажа (-и)	n.		theft
кр'ажа со взл'омом			burglary
красть/укр'асть	v.		to steal
культ'ура (-ы)	n.		culture
междунар'одный	adj.		international
меньшинств'о (-'а)	n.		minority
мн'ение (-я)	n.		opinion
мол'итва (-ы)	n.		prayer
мол'иться/помол'иться (ком'у)	v.		to pray (to)
мон'архия (-и)	n.		monarchy
м'ощный	adj.		powerful, mighty
мусульм'анин (-а)	n.		(male) Moslem/Muslim
наказ'ание (-я)	n.		punishment
нак'азывать/наказ'ать	v.		to punish
напад'ать/нап'асть (на ког'о/что)	v.		to attack
насел'ение (-я)	n.		population
нас'иловать/изнас'иловать	v.		to rape
невин'овный (в чём)	adj.		innocent (of), not guilty (of)
незав'исимость (-и)	n.		independence
несправедл'ивый	adj.		unjust, unfair
обвин'ять/обвин'ить (в чём)	v.		to accuse (of); to charge (with)
обсужд'ать/обсуд'ить	v.		to discuss; to consider
общ'ественный	adj.		social, public
'общество (-а)	n.		society
объявл'ять/объяв'ить войн'у (ком'у)			to declare war (on)
об'ычай (-я)	n.		custom
об'язанность (-и)	n.		duty, obligation, responsibility
оп'асный	adj.		dangerous
ор'ужие (-я)	n.		arm(s), weapon(s)
отв'етственность (-и)	n.		responsibility
поб'еда (-ы)	n.		victory
подж'ог (-а)	n.		arson
пок'ончить с соб'ой		pf.	to kill oneself, to commit suicide
пол'итик (-а)	n.		politician
пол'итика (-и)	n.		politics
полит'ическая п'артия			political party
пол'иция (-и)	n.		police
пос'ольство (-а)	n.		embassy
прав'ительство (-а)	n.		government
пред'атель (-я)	n.		traitor
предрасс'удок (-дка)	n.		prejudice
представ'итель (-я)	n.		representative
презид'ент (-а)	n.		president
преступл'ение (-я)	n.		crime, offence
прест'упник (-а)	n.		criminal, offender
прест'упность (-и)	n.		crime, criminality
пр'ибыль (-и)	n.		profit, gain
пригов'аривать/приговор'ить к см'ерти			to condemn/sentence to death
пригов'ор (-а)	n.		sentence; verdict
призн'ать себ'я вин'овным		pf.	to plead guilty
пром'ышленность (-и)	n.		industry
профсо'юз (-а)	n.		trade union
пыт'ать	v.	impf.	to torture
р'абство (-а)	n.		slavery
рел'игия (-и)	n.		religion
ружьё (-я)	n.		gun, rifle
самоуб'ийство (-а)	n.		suicide
свид'етель (-я)	n.		witness
своб'ода (-ы)	n.		freedom, liberty
сдав'аться/сдаться	v.		to surrender, to yield
см'ертная казнь			(the) death penalty, capital punishment
соверш'ать/соверш'ить преступл'ение			to commit a crime
сов'етская власть			Soviet rule/power
соврем'енный	adj.		contemporary, modern
соглаш'аться/соглас'иться	v.		to agree
справедл'ивый	adj.		just, fair
суд (-'а)	n.		(law)court; trial
торг'овля (-и)	n.		trade, commerce
трад'иция (-и)	n.		tradition
тюрьм'а (-'ы)	n.		prison, jail
убив'ать/уб'ить	v.		to kill; to murder; to assassinate
уб'ийство (-а)	n.		murder
увольн'ять/ув'олить	v.		to dismiss, to sack, to fire
'уличный грабёж			(street) robbery, mugging
христиан'ин (-а)	n.		(male) Christian
христи'анство (-а)	n.		Christianity
церем'ония (-и)	n.		ceremony
ч'астный	adj.		private
шант'аж (-'а)	n.		blackmail
апт'ека (-и)	n.		chemist's (shop)
'арка (-и)	n.		arch
банк (-а)	n.		bank
бар (-а)	n.		bar
басс'ейн (-а)	n.		swimming pool/baths
библиот'ека (-и)	n.		library
больн'ица (-ы)	n.		hospital
б'улочная (-ой)	n.		bakery, baker's (shop)
бюр'о нах'одок			lost-property office
витр'ина (-ы)	n.		(shop) window
вор'ота (-)	n.	pl.	gate(s)
впечатл'яющий	adj.		impressive
вход (-а)	n.		entrance, way in
выбир'ать/в'ыбрать	v.		to choose, to select, to pick
высокок'ачественный	adj.		high-quality
в'ыход (-а)	n.		exit, way out
галер'ея (-и)	n.		gallery
гастрон'ом (-а)	n.		grocer's/grocery (shop)
гул'ять/погул'ять	v.		to (go for a) walk/stroll
движ'ение (-я)	n.		traffic
д'елать/сд'елать пок'упки			to shop, to go shopping
д'енежный автом'ат			cash machine/dispenser
д'еньги (-нег)	n.	pl.	money
дешёвый	adj.		cheap
дор'ога (-и)	n.		road
дорог'ой	adj.		dear, expensive
дор'ожный знак			road sign
заблуд'иться	v.	pf.	to get lost, to lose one's way
зат'ор (-а)	n.		traffic jam, congestion
зд'ание (-я)	n.		building
зооп'арк (-а)	n.		zoo
игр'ушечный магаз'ин			toyshop
иск'ать	v.	impf.	to look/search for, to seek
к'асса (-ы)	n.		checkout, cash-desk; till, cash register
каф'е	n.	nt. indecl.	café/cafe
квит'анция (-и)	n.		receipt
кин'о	n.	nt. indecl.	cinema
ки'оск (-а)	n.		kiosk, stall
кл'умба (-ы)	n.		flower-bed
кн'ижный магаз'ин			bookshop
кред'итная к'арточка			credit card
лифт (-а)	n.		lift
магаз'ин (-а)	n.		shop
м'елочь (-и)	n.		(small) change
меч'еть (-и)	n.		mosque
мон'ета (-ы)	n.		coin
мост (-а)	n.		bridge
муз'ей (-я)	n.		museum
мясн'ой магаз'ин			butcher's (shop)
на втор'ом этаж'е			on the first floor
на п'ервом этаж'е			on the ground floor
нал'ево			on/to the left
напр'аво			on/to the right
наход'ить/найт'и	v.		to find
н'овый	adj.		new
ночн'ой клуб			nightclub
обувн'ой магаз'ин			shoe shop
п'амятник (-а)	n.		memorial, monument
парикм'ахерская (-ой)	n.		hairdresser's, hair salon
парк (-а)	n.		park
перекрёсток (-тка)	n.		crossroads, junction
перех'од (-а)	n.		(pedestrian) crossing
переход'ить/перейт'и (ч'ерез) 'улицу			to cross the street/road
пешех'од (-а)	n.		pedestrian
план г'орода			town plan, street map
плат'ить/заплат'ить (за что)	v.		to pay (for)
плат'ить/заплат'ить нал'ичными			to pay (in) cash
пл'ощадь (-и)	n.		(town) square
под'арок (-рка)	n.		present, gift
под'ержанный	adj.		second-hand
подз'емный перех'од			underpass, subway
пож'арное деп'о			fire station
покуп'атель (-я)	n.		buyer, purchaser; customer
покуп'ать/куп'ить	v.		to buy, to purchase
получ'ать/получ'ить	v.		to receive
посыл'ать/посл'ать письм'о			to send/post a letter
п'очта (-ы)	n.		post office
почт'овый 'ящик			postbox, pillar box
прил'авок (-вка)	n.		counter
прим'ерочная (-ой)	n.		fitting/changing room
пример'ять/прим'ерить	v.		to try on
продав'ать/прод'ать	v.		to sell
распрод'ажа (-и)	n.		(clearance) sale
рестор'ан (-а)	n.		restaurant
р'ыбный магаз'ин			fish shop, fishmonger's (shop)
р'ынок (-нка)	n.		market
светоф'ор (-а)	n.		(set of) traffic lights
синаг'ога (-и)	n.		synagogue
скамь'я (-'и)	n.		bench, seat
ск'идка (-и)	n.		discount, (price) reduction
соб'ор (-а)	n.		cathedral
стади'он (-а)	n.		stadium
ст'атуя (-и)	n.		statue
ст'оить	v.	impf.	to cost
сто'янка маш'ин			car park
сто'янка такс'и			taxi-rank
сто'ять в 'очереди (за что)		impf.	to queue up (for)
те'атр (-а)	n.		theatre
торгов'аться/сторгов'аться (с кем)			to bargain/haggle (with)
торг'овый центр			shopping centre
троту'ар (-а)	n.		pavement
туп'ик (-'а)	n.		dead end, cul-de-sac, blind alley
'угол (угл'а)	n.		corner
'узкий	adj.		narrow
'улица (-ы)	n.		street
универм'аг (-а)	n.		department store
универс'ам (-а)	n.		supermarket
устав'ать/уст'ать	v.		to get/grow tired
фонт'ан (-а)	n.		fountain
цен'а (-'ы)	n.		price, cost
ц'ерковь (-кви)	n.		church
цирк (-а)	n.		circus
чек (-а)	n.		cheque
ч'ековая кн'ижка			chequebook
шир'окий	adj.		wide, broad
эскал'атор (-а)	n.		escalator
эт'аж (-'а)	n.		floor, storey
ювел'ирный магаз'ин			jeweller's (shop), jewellery shop