la acera	n.		pavement
los (grandes) almacenes	n.		department store
ancho	adj.		wide
el aparcamiento	n.		car park
el arco	n.		arch
el ascensor	n.		lift
el ayuntamiento	n.		town/city hall
el banco	n.		bench, seat; bank
el bar	n.		bar
barato	adj.		cheap, inexpensive
la biblioteca	n.		library
el billete (de banco)	n.		(bank)note
de buena calidad			(of) good/high quality
buscar	v.		to look (for), to search (for)
el buzón	n.		postbox, pillar box
la cabina telefónica			telephone box/booth
el café	n.		café/cafe
la caja	n.		checkout, cash desk; till, cash register
el cajero automático			cash machine/dispenser
la calle	n.		street, road
el callejón	n.		alley, passage
el callejón sin salida			dead end, cul-de-sac, blind alley
cansarse	v.		to get/grow tired
la carnicería	n.		butcher's (shop)
caro	adj.		dear, expensive
la catedral	n.		cathedral
el centro comercial			shopping centre
la cesta	n.		basket
el cheque	n.		cheque
el cine	n.		cinema
el circo	n.		circus
el/la cliente	n.		client, customer
la comisaría	n.		police station
comprar	v.		to buy, to purchase
concurrido	adj.		busy, crowded
contar	v.		to count
costar	v.		to cost
el cruce	n.		junction, crossroads
cruzar la calle			to cross the street/road
dar un paseo			to go for a walk
de baja calidad			(of) poor/low quality
de segunda mano			second-hand
el descuento	n.		discount
el dinero	n.		money
el edificio	n.		building
el embotellamiento	n.		traffic jam
encontrar	v.		to find; to meet, to encounter
la entrada	n.		entrance, way in
la escalera mecánica			escalator
el escaparate	n.		(shop) window
escoger	v.		to choose
la esquina	n.		corner
el estadio	n.		stadium
la estatua	n.		statue
estrecho	adj.		narrow
la farmacia	n.		chemist's (shop)
la farola	n.		street lamp/light, lamppost
la frutería	n.		fruit shop
la fuente	n.		fountain
la ganga	n.		bargain, good buy
girar a la derecha			to turn right
girar a la izquierda			to turn left
hacer cola			to queue (up)
hacer la compra			to do the shopping
el hospital	n.		hospital
la iglesia	n.		church
ir a casa			to go home
ir a correos			to go to the post office
ir a la ciudad			to go (in)to town
ir de compras			to go shopping
la joyería	n.		jeweller's (shop), jewellery shop
la juguetería	n.		toyshop
la librería	n.		bookshop
el mercado	n.		market
la mezquita	n.		mosque
la moneda	n.		currency; coin
el monumento	n.		monument, memorial
el mostrador	n.		counter
el museo	n.		museum; gallery
la oficina	n.		office
la oficina de correos			post office
pagar	v.		to pay; to pay for
pagar al contado			to pay (in) cash
pagar con cheque			to pay by cheque
la panadería	n.		baker's (shop), bakery
el parque	n.		park
el parque de bomberos			fire station
el paso de peatones			pedestrian crossing
el paso subterráneo			underpass, subway
la pastelería	n.		cake shop
la peluquería	n.		hairdresser's, hair salon
perderse	v.		to get lost, to lose one's way
la pescadería	n.		fish shop, fishmonger's (shop)
la piscina	n.		swimming pool/baths
el plano	n.		(street) map, plan
la planta baja			ground floor
la plaza	n.		(town) square
el polideportivo	n.		sports/leisure centre
el primer piso			first floor
el probador	n.		fitting/changing room
probarse	v.		to try on
el puente	n.		bridge
el quiosco	n.		kiosk, (news) stand
el recibo	n.		receipt
el reembolso	n.		refund, reimbursement
el regalo	n.		present, gift
el restaurante	n.		restaurant
reunirse (con)	v.		to meet, to meet up (with)
la salida	n.		exit, way out
el semáforo	n.		(set of) traffic lights
la señal (de tráfico)	n.		(road) sign
los servicios	n.		toilet(s)
la sinagoga	n.		synagogue
el solar (para construcción)	n.		building site
el supermercado	n.		supermarket
la tarjeta de crédito			credit card
el teatro	n.		theatre
la tienda	n.		shop
la tienda de ultramarinos			grocer's/grocery (shop)
el túnel	n.		tunnel
la verja	n.		railing(s); iron gate
la zapatería	n.		shoe shop
aceptar	v.		to accept; to approve
alistarse (en el ejército)			to enlist, to join up, to join the army
el arma	n.	f.	weapon, arm
asesinar	v.		to murder; to assassinate
el asesinato	n.		murder; assassination
atacar	v.		to attack
el ataque	n.		attack
la bomba	n.		bomb
el budismo	n.		Buddhism
el/la budista	n.		Buddhist
la cárcel	n.		prison, jail
castigar	v.		to punish
el castigo	n.		punishment
la ceremonia	n.		ceremony
el chantaje	n.		blackmail
civilizado	adj.		civilized
el comercio	n.		commerce, trade
cometer un crimen			to commit a crime
la comunidad	n.		community
condenar	v.		to condemn; to convict
la conquista	n.		conquest
el contrato	n.		contract
la corrupción	n.		corruption
creer	v.		to think, to believe
el crimen	n.		crime
el cristianismo	n.		Christianity
el cristiano	n.		Christian (man)
culpable	adj.		guilty; at fault, to blame
la cultura	n.		culture
declarar la guerra (a)			to declare war (on)
declararse culpable			to plead guilty
el delito menor	n.		minor offence
la democracia	n.		democracy
derrotar	v.		to defeat
el desempleo	n.		unemployment
detener	v.		to arrest, to detain
la deuda	n.		debt
la dictadura	n.		dictatorship
discutir	v.		to discuss, to debate
la economía	n.		economy
económico	adj.		economic; economical
el ejército	n.		army
la elección	n.		election
elegir	v.		to elect
la embajada	n.		embassy
la esclavitud	n.		slavery
la escopeta	n.		(shot)gun
espantoso	adj.		frightful, dreadful; shocking, appalling
estar de acuerdo (con)			to agree (with)
explotar	v.		to exploit
la fábrica	n.		factory
el fraude	n.		fraud, deception; dishonesty
las fuerzas aéreas			air force
fugarse de la cárcel			to escape from prison/jail
gobernar	v.		to rule, to govern
el gobierno	n.		government
la guerra	n.		war
la huelga	n.		strike, walkout
ir a la huelga			to go on strike
imparcial	adj.		impartial, unbiased, fair
importante	adj.		important
la independencia	n.		independence
la industria pesada			heavy industry
la inflación	n.		inflation
injusto	adj.		unjust, unfair
inocente	adj.		innocent
invadir	v.		to invade
la invasión	n.		invasion
la inversión	n.		investment
el Islam	n.		Islam
el judaísmo	n.		Judaism
el judío	n.		(male) Jew, Jewish man
el juicio	n.		trial; verdict, judgement
la justicia	n.		justice
justo	adj.		just, fair
la ley	n.		law
la libertad	n.		liberty, freedom
lícito	adj.		legal, lawful
luchar	v.		to fight, to struggle
la manifestación	n.		demonstration, rally
la marina (de guerra)	n.		navy
matar	v.		to kill
la mayoría	n.		majority
la minoría	n.		minority
moderno	adj.		modern
la monarquía	n.		monarchy
el musulmán	n.		Moslem/Muslim (man)
la nacionalidad	n.		nationality
la opinión pública			public opinion
la opresión	n.		oppression
el partido político			political party
la paz	n.		peace
peligroso	adj.		dangerous, risky
la pena de muerte			(the) death penalty, capital punishment
la población	n.		population
poderoso	adj.		powerful
la policía	n.		police
la política	n.		politics; policy
político	adj.		political
el/la presidente	n.		president
prohibir	v.		to prohibit, to ban, to forbid
protestar	v.		to protest
público	adj.		public
rebelarse	v.		to revolt, to rebel
la reina	n.		queen
la religión	n.		religion
rendirse	v.		to yield, to surrender; to give oneself up
el rey	n.		king
robar	v.		to rob; to steal; to break into
el robo	n.		robbery, theft
santo	adj.		holy
seguro	adj.		safe; secure
significativo	adj.		significant
el sindicato	n.		trade union
la sociedad	n.		society; company
subir al poder			to come (in)to power, to gain power
suicidarse	v.		to commit suicide
el terrorismo	n.		terrorism
el testigo ocular			eye witness
el testimonio	n.		testimony, evidence
el tipo de interés			interest rate
torturar	v.		to torture
la tradición	n.		tradition
la traición	n.		treason; treachery; betrayal
el vandalismo	n.		vandalism
el veredicto	n.		verdict
la violación	n.		rape; violation
violar	v.		to rape; to violate
votar	v.		to vote (for)
el abogado	n.		(male) lawyer
la abuela	n.		grandmother
el abuelo	n.		grandfather
los abuelos	n.		grandparents
el actor	n.		actor
la actriz	n.		actress
admirar	v.		to admire
la adolescencia	n.		adolescence
la adulta	n.		(female) adult
el adulto	n.		(male) adult
agresivo	adj.		aggressive
alegre	adj.		cheerful, happy, carefree
amable	adj.		kind; nice
amar	v.		to love
ambicioso	adj.		ambitious
la amiga	n.		(female) friend
el amigo	n.		(male) friend
los antepasados	n.		ancestors
el apellido	n.		surname, last name
el arquitecto	n.		(male) architect
arrogante	adj.		arrogant
el/la artista	n.		artist, painter; artiste
atractivo	adj.		attractive
el bailarín	n.		(male) dancer
el bebé	n.		baby
el bibliotecario	n.		(male) librarian
la boda	n.		wedding, marriage
el bombero	n.		fireman, fire-fighter
el camarero	n.		waiter
el camionero	n.		(male) lorry driver
el/la cantante	n.		singer
el cartero	n.		postman
casarse (con)	v.		to marry, to get married (to)
el científico	n.		(male) scientist
el cirujano	n.		(male) surgeon
el cocinero	n.		(male) cook
compadecer	v.		to pity, to be sorry for
el compositor	n.		(male) composer
conocer	v.		to know; to meet, to get to know
el constructor	n.		(male) builder
el/la contable	n.		accountant, bookkeeper
el/la cónyuge	n.		spouse, partner
cruel	adj.		cruel
débil	adj.		weak
el/la dentista	n.		dentist
el dependiente	n.		(male) shop/sales assistant
deprimirse	v.		to become/get depressed
despreciar	v.		to scorn, to despise
el diplomático	n.		(male) diplomat
la dirección	n.		address
la edad	n.		age
egoísta	adj.		selfish
el/la electricista	n.		electrician
el/la espía	n.		spy
enamorarse (de)	v.		to fall in love (with)
el enfermero	n.		(male) nurse
envidioso	adj.		envious; jealous
el escritor	n.		(male) writer
la estrella de cine			film/movie star
estúpido	adj.		stupid, silly
la familia	n.		family
famoso	adj.		famous
la fecha de nacimiento			date of birth
felicitar	v.		to compliment
feliz	adj.		happy; lucky, fortunate
feo	adj.		ugly
el fotógrafo	n.		(male) photographer
fuerte	adj.		strong
el funcionario	n.		(male) official; (male) civil servant
el funeral	n.		funeral
generoso	adj.		generous
el granjero	n.		(male) farmer
la hermana	n.		sister
el hermano	n.		brother
la hija	n.		daughter
la hijastra	n.		stepdaughter
el hijastro	n.		stepson
el hijo	n.		son
el hombre	n.		man
el hombre de negocios			businessman
el ingeniero	n.		(male) engineer
insultar	v.		to insult
inteligente	adj.		intelligent
el jardinero	n.		(male) gardener
joven	adj.		young
jubilarse	v.		to retire
el/la juez	n.		judge
la madrastra	n.		stepmother
la madre	n.		mother
el marido	n.		husband
el matrimonio	n.		marriage, matrimony
el mecánico	n.		(male) mechanic
el médico	n.		(male) doctor
el minero	n.		(male) miner
modesto	adj.		modest
morir	v.		to die
la muerte	n.		death
la mujer	n.		woman; wife
el/la músico	n.		musician
nacer	v.		to be born
el nacimiento	n.		birth
nervioso	adj.		nervous; highly-strung; restless
la nieta	n.		granddaughter
el nieto	n.		grandson
los nietos	n.		grandchildren
la niña	n.		(little) girl
la niñez	n.		childhood
el niño	n.		(little) boy
el nombre	n.		name
la novia	n.		girlfriend
el novio	n.		boyfriend
la nuera	n.		daughter-in-law
el número de teléfono			telephone number
la ocupación	n.		occupation
odiar	v.		to hate
orgulloso	adj.		proud; haughty
el padrastro	n.		stepfather
el padre	n.		father
los padres	n.		parents
el/la pariente	n.		relative/relation
el peluquero	n.		(male) hairdresser
perdonar	v.		to pardon, to forgive; to excuse
el/la periodista	n.		journalist
la persona	n.		person
el pescador	n.		fisherman
el/la piloto	n.		pilot
el pintor	n.		(male) painter
pobre	adj.		poor
el/la policía	n.		policeman/policewoman
el/la político	n.		politician
presentar (a)	v.		to introduce (to)
la prima	n.		(female) cousin
el primo	n.		(male) cousin
reconocer	v.		to recognize
rencoroso	adj.		spiteful, nasty, malicious
rico	adj.		rich, wealthy
el secretario	n.		(male) secretary
simpático	adj.		nice, likeable, pleasant
el/la soldado	n.		soldier
la suegra	n.		mother-in-law
el suegro	n.		father-in-law
el/la taxista	n.		taxi driver
la tía	n.		aunt, aunty/auntie
tímido	adj.		shy, timid
el tío	n.		uncle
triste	adj.		sad, melancholy, unhappy
la vida	n.		life
viejo	adj.		old
vivir	v.		to live
el yerno	n.		son-in-law
la abeja	n.		bee
el agua	n.	f.	water
el águila	n.	f.	eagle
el aire	n.		air
el alud	n.		avalanche
el animal	n.		animal
la araña	n.		spider
el árbol	n.		tree
el arbusto	n.		bush, shrub
el arco iris			rainbow
arder	v.		to burn, to blaze
la arena	n.		sand
el arroyo	n.		stream, brook
la atmósfera	n.		atmosphere
la avispa	n.		wasp
la bahía	n.		bay
el bosque	n.		wood(s), forest
brillar	v.		to shine
la brisa	n.		breeze
el burro	n.		donkey
el caballo	n.		horse
el caracol	n.		snail
la cascada	n.		waterfall
el cerdo	n.		pig
la charca	n.		pond, pool
el cielo	n.		sky
el clima	n.		climate
el cocodrilo	n.		crocodile
la colina	n.		hill
el conejo	n.		rabbit
la constelación	n.		constellation
el continente	n.		continent
la costa	n.		coast
crecer	v.		to grow, to increase
la cucaracha	n.		cockroach
el desierto	n.		desert
el elefante	n.		elephant
erosionar	v.		to erode
el espacio	n.		space
está lloviendo			it's raining
está nevando			it's snowing
está nublado			it's cloudy
la estrella	n.		star
fértil	adj.		fertile
la flor	n.		flower
florecer	v.		to flower, to bloom, to blossom
el fuego	n.		fire
la galaxia	n.		galaxy
el gato	n.		cat
el granizo	n.		hail
hace calor			it's hot/warm
hace frío			it's cold
hace sol			it's sunny
hace viento			it's windy
hay niebla			it's foggy
la helada	n.		frost
el hielo	n.		ice
la hierba	n.		grass; herb
la hoja	n.		leaf
la hormiga	n.		ant
húmedo	adj.		humid; damp, wet
el huracán	n.		hurricane
el insecto	n.		insect
la inundación	n.		flood
la isla	n.		island
la jungla	n.		jungle
el lago	n.		lake
el león	n.		lion
la llovizna	n.		drizzle
la lluvia	n.		rain
lluvioso	adj.		rainy, wet
el lobo	n.		wolf
la lombriz	n.		(earth)worm
la luna	n.		moon
el mar	n.		sea
la marea	n.		tide
la mariposa	n.		butterfly
la montaña	n.		mountain(s)
el mosquito	n.		mosquito
muerto	adj.		dead
el mundo	n.		world
el murciélago	n.		bat
natural	adj.		natural
la naturaleza	n.		nature
la niebla	n.		fog, mist
la nieve	n.		snow
el nubarrón	n.		storm cloud
la nube	n.		cloud
el océano	n.		ocean
la ola	n.		wave
orbitar	v.		to orbit
la orilla	n.		shore, (river)bank
el oso	n.		bear
la oveja	n.		sheep
el pantano	n.		marsh, swamp, bog
el perro	n.		dog
el pez	n.		fish
la piedra	n.		stone
el planeta	n.		planet
la planta	n.		plant
poco profundo			shallow, not very deep
el pollo	n.		chicken
el prado	n.		meadow, field; pasture
profundo	adj.		deep
pudrirse	v.		to rot, to decay
la raíz	n.		root
la rama	n.		branch
el ratón	n.		mouse
el relámpago	n.		(flash of) lightning
reproducirse	v.		to breed
el río	n.		river
la roca	n.		rock
seco	adj.		dry
la semilla	n.		seed
la serpiente	n.		snake
el sistema solar			solar system
el sol	n.		sun; sunshine, sunlight
el tallo	n.		stem
el terremoto	n.		earthquake
el tiempo	n.		weather
la tierra	n.		earth, soil, land
el tigre	n.		tiger
la tormenta	n.		storm
el tronco	n.		(tree) trunk
el trueno	n.		thunder
el universo	n.		universe
la vaca	n.		cow
el valle	n.		valley
la vegetación	n.		vegetation
la ventisca	n.		blizzard
el viento	n.		wind
vivo	adj.		living, live, alive
el volcán	n.		volcano
el zorro	n.		fox
actuar	v.		to act, to perform
agradable	adj.		pleasant, nice, agreeable
el ajedrez	n.		chess
aplaudir	v.		to applaud, to clap
el árbitro	n.		referee; umpire
el arte	n.		art
el atletismo	n.		athletics
el auditorio	n.		audience; auditorium, hall
bailar	v.		to dance
el ballet	n.		ballet
el balón	n.		(large) ball
la banda	n.		(brass) band
la baraja	n.		pack/deck (of cards)
la batería	n.		drums, drum kit
el billar americano			pool
el boxeo	n.		boxing
el campeonato	n.		championship
el canal (de televisión)	n.		(television) channel
la canción	n.		song
cantar	v.		to sing
el capítulo	n.		chapter
la ciencia-ficción	n.		science fiction
el clarinete	n.		clarinet
la comedia	n.		comedy; play, drama
el concierto	n.		concert; concerto
el coro	n.		choir, chorus
el críquet	n.		cricket
el crucigrama	n.		crossword
el cuento	n.		story, tale; short story
el deporte	n.		sport
desagradable	adj.		unpleasant, disagreeable
el descanso	n.		rest, break; interval; half-time
dibujar	v.		to draw
el dibujo	n.		drawing
divertido	adj.		amusing, entertaining
divertir	v.		to amuse, to entertain
divertirse	v.		to amuse/enjoy oneself, to have fun
el documental	n.		documentary
echar los dados			to throw the dice
la emisora (de radio)	n.		(radio) station
emitir	v.		to broadcast
emocionante	adj.		exciting, thrilling; touching, moving
el empate	n.		draw, tie
el ensayo general			dress rehearsal
el equipo	n.		team
escalar una montaña			to climb a mountain
la escena	n.		stage; scene
escuchar la radio			to listen to the radio
la escultura	n.		sculpture
el espectáculo de variedades			variety show
el esquí	n.		skiing
excelente	adj.		excellent
la exposición	n.		exhibition, show
favorito	adj.		favourite
la flauta	n.		flute
el fútbol	n.		football
ganar	v.		to win
la gimnasia	n.		gymnastics
el golf	n.		golf
la guitarra	n.		guitar
el/la hincha	n.		(football) fan/supporter
improvisar	v.		to improvise
el instrumento	n.		instrument
ir a nadar			to go swimming, to go for a swim
el jazz	n.		jazz
el juego	n.		game; play, playing
el juego de ordenador			computer game
jugar	v.		to play
jugar a las cartas			to play cards
jugar al fútbol			to play football
leer	v.		to read
el libro	n.		book
el lienzo	n.		canvas
la literatura	n.		literature
marcar un gol			to score a goal
la música	n.		music
la música clásica			classical music
las noticias	n.		news
la novela	n.		novel
la novela policíaca			detective story/novel
el oboe	n.		oboe
la obra (dramática)	n.		(stage) play
la ópera	n.		opera
la orquesta	n.		orchestra
el partido de fútbol			football match/game
el pasatiempo	n.		pastime, hobby
el patinaje	n.		skating
la película	n.		film, movie
la película de terror			horror film/movie
la pelota	n.		(small) ball
perder	v.		to lose
el periódico	n.		newspaper
el piano de cola			grand piano
el pincel	n.		(artist's) paintbrush
pintar	v.		to paint
la pintura	n.		painting
el poema	n.		poem
la poesía	n.		poetry
el pop	n.		pop (music)
el programa concurso			game/quiz show
el programa (de televisión)			(television) programme
la raqueta	n.		racket/racquet
la representación	n.		performance
el retrato	n.		portrait
la revista			magazine, journal, review
el saxofón	n.		saxophone
sentimental	adj.		sentimental
la serie (de televisión)	n.		(television) series/serial
el tambor	n.		drum
el tenis	n.		tennis
el tiempo libre			spare/free time
el título	n.		title
tocar de oído			to play by ear
tocar el piano			to play the piano
tocar la guitarra			to play the guitar
los toros	n.		bullfight; bullfighting
la tragedia	n.		tragedy
el trombón	n.		trombone
la trompeta	n.		trumpet
el truco de cartas			card trick
ver la televisión			to watch television
el violín	n.		violin
el violonchelo	n.		cello
abajo			downstairs
abrir	v.		to open
acostarse	v.		to go to bed; to lie down
el alféizar	n.		window sill
la alfombra	n.		carpet; rug, mat
la almohada	n.		pillow
amplio	adj.		spacious, roomy
apagar	v.		to turn/switch off
el aparador	n.		sideboard
el armario	n.		wardrobe, cupboard
arriba			upstairs
el balcón	n.		balcony
bañarse	v.		to have/take a bath
el baño	n.		bathroom
ir al baño			to go to the toilet
barrer	v.		to sweep
el cajón	n.		drawer
la calefacción central			central heating
el calentador	n.		heater
la cama	n.		bed
en casa			at home
la casa	n.		house
la casita	n.		small house, cottage
cepillarse los dientes			to brush one's teeth
el cepillo	n.		brush
la cera abrillantadora			wax polish
la cerradura	n.		lock
cerrar	v.		to close, to shut
cerrar la puerta con llave			to lock the door
el césped	n.		lawn, grass
el champú	n.		shampoo
la chimenea	n.		chimney; fireplace
la cocina	n.		kitchen; cooker, stove
el cojín	n.		cushion
el comedor	n.		dining room
la cómoda	n.		chest of drawers
cómodo	adj.		comfortable
el congelador	n.		freezer
construir	v.		to build, to construct
la contraventana	n.		shutter
correr las cortinas			to close/draw the curtains
la cortina	n.		curtain
el cuadro	n.		picture, painting
el cuarto	n.		room
el cubo	n.		bucket
el cubo de la basura	n.		(rubbish) bin, dustbin
dentro			inside; indoors
descorrer las cortinas			to open/draw the curtains
desordenado	adj.		untidy
el despacho	n.		study
el despertador	n.		alarm clock
despertarse	v.		to wake up
dormirse	v.		to go to sleep; to fall asleep
el dormitorio	n.		bedroom
la ducha	n.		shower
ducharse	v.		to have/take a shower
encender	v.		to turn/switch on
el enchufe	n.		plug; (electric) socket, power point
la escalera	n.		staircase, stairs
la escoba	n.		broom, brush
el escritorio	n.		(writing) desk
el espejo	n.		mirror
el estante	n.		shelf
la estantería	n.		bookcase, shelves
el fregadero	n.		(kitchen) sink
la fregona	n.		mop
fuera			outside
el garaje	n.		garage
hacer la cama			to make the bed
hacer la colada			to do the washing/laundry
el horno	n.		oven
el horno microondas			microwave (oven)
el interruptor	n.		switch
el jabón	n.		soap; bar of soap
el jardín	n.		garden
el lavabo	n.		washbasin, (bathroom) sink
la lavadora	n.		washing machine
lavarse	v.		to wash (oneself), to have a wash
el lavavajillas	n.	inv.	dishwasher
levantarse	v.		to get up, to rise
limpiar	v.		to clean; to wipe
limpio	adj.		clean
la llave	n.		key
la manta	n.		blanket
la mesa	n.		table
moderno	adj.		modern
los muebles	n.		furniture
el muro	n.		(exterior) wall
la nevera	n.		fridge, refrigerator
ordenado	adj.		tidy
oscuro	adj.		dark; dim, gloomy
la pared	n.		(interior) wall
la pasta de dientes			toothpaste
peinarse	v.		to comb one's hair
la persiana	n.		(Venetian) blind
pintar	v.		to paint
el piso	n.		floor, storey; flat, apartment
la plancha	n.		iron
planchar	v.		to iron; to do the ironing
el polvo	n.		dust
polvoriento	adj.		dusty
la puerta	n.		door; gate
la radio	n.		radio
renovar	v.		to renovate, to do up; to redecorate
reparar	v.		to repair
la sábana	n.		sheet
la sala (de estar)	n.		living/sitting room, lounge
sentarse	v.		to sit (down)
la silla	n.		chair
el sillón	n.		armchair
el sofá	n.		sofa, settee
la suciedad	n.		dirt, grime
sucio	adj.		dirty, grimy
el suelo	n.		floor; ground
el techo	n.		ceiling
el tejado	n.		roof
el teléfono	n.		telephone
la televisión	n.		television
tender la colada			to hang out/up the washing/laundry
la toalla	n.		towel
el tocador	n.		dressing table
el trapo	n.		cloth, rag
el váter	n.		toilet, lavatory
la ventana	n.		window
el vídeo	n.		video (cassette) recorder, video
el accidente	n.		accident
agudo	adj.		acute; sharp
la ambulancia	n.		ambulance
el antibiótico	n.		antibiotic
el anticonceptivo	n.		contraceptive
el antidepresivo	n.		antidepressant
el antiséptico	n.		antiseptic
el asma	n.	f.	asthma
la barbilla	n.		chin
el bigote	n.		moustache
la boca	n.		mouth
el brazo	n.		arm
la bronquitis	n.		bronchitis
el cabestrillo	n.		sling
la cabeza	n.		head
la cadera	n.		hip
el cáncer	n.		cancer
la cara	n.		face
la carne	n.		flesh
la ceja	n.		eyebrow
el cerebro	n.		brain
la cicatriz	n.		scar
la cintura	n.		waist
la cirugía	n.		surgery
el codo	n.		elbow
consolar	v.		to console, to comfort
contagioso	adj.		contagious, infectious
el corazón	n.		heart
el cráneo	n.		skull
el cuello	n.		neck
el cuerpo	n.		body
la cura	n.		cure
débil	adj.		weak; feeble, frail
el dedo	n.		finger
el dedo (del pie)			toe
el dedo gordo			big toe
dejar de fumar			to give up smoking, to stop/quit smoking
descansar	v.		to (have a) rest
desmayarse	v.		to faint, to swoon
la diabetes	n.		diabetes
el diente	n.		tooth
el dolor	n.		pain, ache
doloroso	adj.		painful
la dosis	n.	inv.	dose
los efectos secundarios			side effects
el diagnóstico	n.		diagnosis
el empaste	n.		filling
enfermar	v.		to fall/become ill, to be taken ill
la enfermedad	n.		illness, sickness; disease
enfermo	adj.		ill, sick, unwell
la epidemia	n.		epidemic
la erupción (cutánea)	n.		rash, (skin) eruption
la espalda	n.		back
el espinazo	n.		spine, backbone
el esqueleto	n.		skeleton
el estómago	n.		stomach
en (buena) forma			fit, in good shape
la frente	n.		forehead, brow
fuerte	adj.		strong; tough, robust
fumar	v.		to smoke
el furúnculo	n.		boil
la garganta	n.		throat
el grano	n.		spot, pimple
grave	adj.		serious, grave, critical; severe
la gripe	n.		flu, influenza
hacer ejercicio			to (take) exercise, to do/get some exercise
la herida	n.		wound, injury
el hígado	n.		liver
el hombro	n.		shoulder
el hueso	n.		bone
incurable	adj.		incurable
el infarto	n.		heart attack
la ingle	n.		groin
la inyección	n.		injection
la jeringa	n.		syringe
el labio	n.		lip
la lengua	n.		tongue
llorar	v.		to cry, to weep
la mandíbula	n.		jaw
la mano	n.		hand
mantenerse en forma			to keep fit
estar mareado			to feel sick/dizzy
el medicamento	n.		medicine, drug
la mejilla	n.		cheek
el miembro	n.		limb
morir	v.		to die
la muleta	n.		crutch
la muñeca	n.		wrist
el músculo	n.		muscle
el muslo	n.		thigh
la nariz	n.		nose
la nutrición	n.		nutrition
el ojo	n.		eye
la operación	n.		operation
la oreja	n.		ear
el órgano	n.		organ
el/la paciente	n.		patient
pálido	adj.		pale
el pecho	n.		chest, breast
el pelo	n.		hair
el pene	n.		penis
la pestaña	n.		eyelash
el pie	n.		foot
la piel	n.		skin
la pierna	n.		leg
la píldora	n.		pill
el preservativo	n.		condom
el pulgar	n.		thumb
el pulmón	n.		lung
el pulso	n.		pulse
la receta	n.		prescription
recuperarse	v.		to recover, to get better, to recuperate
el resfriado	n.		cold
resfriarse	v.		to catch/get a cold
respirar	v.		to breathe
el riñón	n.		kidney
la rodilla	n.		knee
romperse la pierna			to break one's leg
ronco	adj.		hoarse
la salud	n.		health
la sangre	n.		blood
sano	adj.		healthy, fit
el sedante	n.		sedative
la sien	n.		temple
la silla de ruedas			wheelchair
el somnífero	n.		sleeping pill/tablet
el sudor	n.		sweat
sufrir (de)	v.		to suffer (from)
el talón	n.		heel
tener dolor de cabeza			to have a headache
tener dolor de espalda			to have (a) backache
tener dolor de estómago			to have (a) stomach ache
tener dolor de muelas			to have (a) toothache
la tensión	n.		blood pressure
el termómetro	n.		thermometer
la tirita	n.		(sticking) plaster
el tobillo	n.		ankle
tomar la píldora			to be on the pill
el tratamiento	n.		treatment
el tumor	n.		tumour, growth
la úlcera	n.		ulcer
la uña	n.		(finger/toe)nail
la vagina	n.		vagina
la vejiga	n.		bladder
la venda	n.		bandage
el veneno	n.		poison, venom
el vientre	n.		belly, stomach
el aceite	n.		oil
agrio	adj.		sour
el ajo	n.		garlic
el albaricoque	n.		apricot
el aliño	n.		dressing
almorzar	v.		to (have) lunch
amargo	adj.		bitter
el apio	n.		celery
aromático	adj.		aromatic
el arroz	n.		rice
asar	v.		to roast
el azúcar	n.		sugar
beber	v.		to drink
la bebida	n.		drink, beverage
la berenjena	n.		aubergine
la cacerola	n.		(sauce)pan
el café	n.		coffee
el caldo	n.		stock; (thin) soup
caliente	adj.		warm, hot
la carne	n.		meat
la carta	n.		menu
la cebolla	n.		onion
la cena	n.		dinner, supper, evening meal
cenar	v.		to have dinner/supper, to dine
el cerdo	n.		pork
la cereza	n.		cherry
la cerveza	n.		beer
el champiñón	n.		mushroom
el chocolate	n.		chocolate
la ciruela	n.		plum
cocinar	v.		to cook
la col	n.		cabbage
la coliflor	n.		cauliflower
comer	v.		to eat; to have lunch
la comida	n.		food; meal; lunch
el condimento	n.		seasoning, flavouring, condiment
congelado	adj.		frozen
el cordero	n.		lamb
crudo	adj.		raw
los cubiertos	n.		cutlery
la cuchara	n.		spoon
el cuchillo	n.		knife
la cuenta	n.		bill (in restaurant)
desayunar	v.		to (have) breakfast
el desayuno	n.		breakfast
dulce	adj.		sweet
duro	adj.		tough, hard
la ensalada	n.		salad
la especia	n.		spice
las espinacas	n.		spinach
flojo	adj.		weak
la frambuesa	n.		raspberry
fregar los platos			to wash up, to do the washing-up/dishes
freír	v.		to fry
la fresa	n.		strawberry
fresco	adj.		fresh; cool, chilled
la fruta	n.		(piece of) fruit
fuerte	adj.		strong
la galleta	n.		biscuit; cracker
la gaseosa	n.		lemonade
la grosella negra			blackcurrant
el guisante	n.		pea
la harina	n.		flour
hervir	v.		to boil
la hierba	n.		herb
el huevo	n.		egg
el jamón	n.		ham
la judía	n.		bean
la lata	n.		tin, can
la leche	n.		milk
la lechuga	n.		lettuce
el limón	n.		lemon
el maíz	n.		maize, sweet corn
la mantequilla	n.		butter
la manzana	n.		apple
el melocotón	n.		peach
el melón	n.		melon
la mermelada	n.		jam; marmalade
la miel	n.		honey
la mostaza	n.		mustard
muy hecho			overdone; well done
la naranja	n.		orange
la nata	n.		cream
la nuez	n.		nut; walnut
oler	v.		to smell
el pan	n.		bread; loaf (of bread)
pasado	adj.		old; stale, bad; overripe
la patata	n.		potato
el pepino	n.		cucumber
la pera	n.		pear
el pescado	n.		fish
picante	adj.		hot, spicy
la pimienta	n.		(ground) pepper
el pimiento	n.		pepper (vegetable)
la piña	n.		pineapple
el plátano	n.		banana
el platillo	n.		saucer
el plato	n.		plate, dish; course
el plato principal	n.		main course
poco hecho			underdone; rare
podrido	adj.		rotten
el pollo	n.		chicken
el pomelo	n.		grapefruit
poner la mesa			to set/lay the table
el postre	n.		dessert
probar	v.		to try, to taste, to sample
el puerro	n.		leek
el queso	n.		cheese
recoger la mesa			to clear the table
la remolacha	n.		beetroot
sabroso	adj.		nice, tasty
la sal	n.		salt
salado	adj.		salty, salted
la salchicha	n.		sausage
la salsa	n.		sauce; gravy
la sartén	n.		frying pan
la sidra	n.		cider
la sopa	n.		soup
el tarro	n.		jar, pot
la tarta	n.		cake; tart
la taza	n.		cup, mug
el té	n.		tea
el tenedor	n.		fork
tener hambre			to be hungry
tener sed			to be thirsty
tierno	adj.		tender, soft
tomar un bocado			to have a bite to eat, to have a snack
el tomate	n.		tomato
tostar	v.		to toast, to brown
el trigo	n.		wheat
la uva	n.		grape
la uva pasa			raisin
el vaso	n.		glass, tumbler
las verduras	n.		greens, (cooked) vegetables
el vinagre	n.		vinegar
el vino	n.		wine
la zanahoria	n.		carrot
el zumo	n.		juice
aburrido	adj.		boring; bored
el alumno	n.		(male) pupil, schoolboy
aplicado	adj.		diligent, industrious, hard-working
aprender	v.		to learn
aprender de memoria			to learn by heart, to memorize
aprobar un examen			to pass an exam
el arte	n.		art
el atletismo	n.		athletics
la biología	n.		biology
la calculadora	n.		calculator
el campo (de fútbol)	n.		(football) pitch/field
la ciencia	n.		science
las ciencias políticas			(study of) politics, political science
la clase	n.		class, lesson, lecture; classroom
las clases nocturnas			evening classes
la coma	n.		comma
complicado	adj.		complicated
la composición	n.		composition; essay
el conocimiento	n.		knowledge
los conocimientos generales			general knowledge
copiar	v.		to copy
correcto	adj.		correct, right
creativo	adj.		creative
el cuaderno	n.		exercise book, notebook
culto	adj.		cultured, (well-)educated
el curso por correspondencia			correspondence course
dar buen ejemplo			to set a good example
los deberes	n.		homework
desobediente	adj.		disobedient
el diccionario	n.		dictionary
el dictado	n.		dictation
difícil	adj.		difficult
el director	n.		(male) headteacher, headmaster
los dos puntos			colon
dotado	adj.		gifted
la educación	n.		education; upbringing; (good) manners
la educación física			physical education, PE
el ejemplo	n.		example
el ejercicio	n.		exercise
la enseñanza	n.		education; teaching, schooling, tuition
enseñar	v.		to teach
entender	v.		to understand
entender mal			to misunderstand
entusiasta	adj.		enthusiastic, keen
estar equivocado			to be wrong/mistaken
el error	n.		error, mistake
escribir	v.		to write
la escuela	n.		school
el/la estudiante	n.		student
estudiar	v.		to study
el examen	n.		exam
el examen de ingreso			entrance exam
fácil	adj.		easy
la filosofía	n.		philosophy
la física	n.		physics
la frase	n.		sentence; phrase, expression
la geografía	n.		geography
la goma (de borrar)	n.		rubber, eraser
la gramática	n.		grammar
hacer un examen			to take/sit an exam
hacer una pregunta			to ask a question
la historia	n.		history
la hora de comer			lunch/dinner time
incorrecto	adj.		incorrect, wrong
la informática	n.		computer science, information technology
interesante	adj.		interesting
el lápiz	n.		pencil; crayon
leer	v.		to read
el libro de texto			textbook
el licenciado	n.		(male) graduate
licenciarse (en)	v.		to graduate (in), to get a degree (in)
la licenciatura	n.		(university) degree; graduation; degree course
la literatura	n.		literature
las matemáticas	n.		mathematics, maths
la materia	n.		(school) subject
mostrar	v.		to show, to demonstrate
la música	n.		music
la natación	n.		swimming
la nota	n.		grade, mark
obediente	adj.		obedient
olvidarse (de)	v.		to forget
el ordenador	n.		computer
la página	n.		page
el párrafo	n.		paragraph
el parvulario			nursery school, kindergarten
pedir	v.		to ask (for), to request
perezoso	adj.		lazy
la pizarra	n.		blackboard
la pluma	n.		pen
portarse bien			to behave (well), to behave oneself
portarse mal			to misbehave, to behave badly
la pregunta	n.		question
preguntar	v.		to ask, to inquire
el profesor	n.		(male) teacher/lecturer
el punto	n.		full stop; point; dot
el punto y coma			semicolon
la puntuación	n.		punctuation
el pupitre	n.		desk
la química	n.		chemistry
recordar	v.		to remember, to recall
el recreo	n.		break(time), playtime
la regla	n.		ruler
repetitivo	adj.		repetitive
responder a una pregunta			to answer a question
la respuesta	n.		answer, reply, response
el resultado	n.		result
saber	v.		to know
sencillo	adj.		simple, straightforward
los signos de admiración			exclamation marks
los signos de interrogación			question marks
la sociología	n.		sociology
subrayar	v.		to underline
suspender un examen			to fail an exam
tachar	v.		to cross out; to correct
el tema	n.		theme, topic, subject
tener razón			to be right
la teología	n.		theology
los títulos	n.		qualifications
la tiza	n.		chalk
travieso	adj.		naughty
el uniforme escolar	n.		school uniform
la universidad	n.		university
abotonar	v.		to button (up)
el abrigo	n.		coat, overcoat
abrochar	v.		to do up, to fasten
la aguja	n.		needle
el alfiler	n.		pin
el algodón	n.		cotton
amarillo	adj.		yellow
ancho	adj.		wide, big, loose(-fitting)
el anillo	n.		ring
apretado	adj.		tight
arreglar	v.		to mend, to repair
áspero	adj.		rough
azul	adj.		blue
el bañador	n.		swimming/bathing costume, swimming trunks
blanco	adj.		white
blando	adj.		soft
la blusa	n.		blouse; overall
el bolsillo	n.		pocket
el bolso	n.		handbag
la bota	n.		boot
el botón	n.		button
las bragas	n.		knickers
brillante	adj.		bright, brilliant; shiny, glossy
la bufanda	n.		scarf
el calcetín	n.		sock
el calzado	n.		footwear
los calzoncillos	n.		underpants
cambiarse	v.		to change, to get changed
la camisa	n.		shirt
la camiseta	n.		T-shirt/tee-shirt; vest
el camisón	n.		nightdress, nightie
la chaqueta	n.		jacket
el cinturón	n.		belt
el collar	n.		necklace
el color	n.		colour
cómodo	adj.		comfortable
la corbata	n.		tie; cravat(e)
el cordón (de zapato)	n.		(shoe)lace
la correa	n.		strap
corto	adj.		short
coser	v.		to sew (up/on)
la cremallera	n.		zip
el cuello	n.		collar
el cuero	n.		leather
desabotonar	v.		to unbutton
desabrochar	v.		to undo, to unfasten
desnudarse	v.		to undress (oneself), to get undressed, to strip
desnudo	adj.		naked, bare, nude
dorado	adj.		gold (in colour), golden
elegante	adj.		elegant
entallar	v.		to (be a good) fit
la falda	n.		skirt
el forro	n.		lining
las gafas	n.		glasses, spectacles
las gafas de sol			sunglasses
la gorra	n.		(peaked) cap
gris	adj.		grey
grueso	adj.		thick; coarse
el guante	n.		glove
el hilo	n.		thread
el impermeable	n.		raincoat, waterproof (coat)
el jersey	n.		jersey, sweater, pullover, jumper
las joyas	n.		jewellery, jewels
la lana	n.		wool
largo	adj.		long
la mancha	n.		stain, mark, spot
la manga	n.		sleeve
el maquillaje	n.		make-up
la máquina de coser			sewing machine
marrón	adj.		brown
las medias	n.		stockings
de moda			fashionable
el monedero	n.		purse
morado	adj.		purple
naranja	adj.	inv.	orange
negro	adj.		black
el nylon	n.		nylon
de oro			gold, (made) of gold
los pantalones	n.		trousers
los pantalones cortos			short trousers, shorts
el pañuelo	n.		handkerchief; (head)scarf
el paraguas	n.	inv.	umbrella
el pendiente	n.		earring; pendant
el perfume	n.		scent, perfume
el pijama	n.		(pair of) pyjamas
de plata			silver, (made) of silver
plateado	adj.		silver (in colour), silvery
ponerse	v.		to put on
la prenda	n.		garment, article of clothing
la pulsera	n.		bracelet
quitar	v.		to take off, to remove
rasgar	v.		to tear, to rip
el reloj (de pulsera)	n.		(wrist)watch
rojo	adj.		red
la ropa	n.		clothing, clothes
la ropa interior			underwear, underclothes
rosa	adj.	inv.	pink
la sandalia	n.		sandal
la seda	n.		silk
el sombrero	n.		hat
suave	adj.		smooth
el sujetador	n.		bra
la talla	n.		size
la tela	n.		cloth, fabric, material
teñir	v.		to dye
el terciopelo	n.		velvet
el traje	n.		(man's) suit
tricotar	v.		to knit
el uniforme	n.		uniform
los vaqueros	n.		jeans
el velo	n.		veil
verde	adj.		green
el vestido	n.		(woman's) dress
vestirse	v.		to dress (oneself), to get dressed
la zapatilla	n.		slipper
el zapato	n.		shoe
los zapatos de tacón (alto)			high-heeled shoes, high heels
la aduana	n.		customs
el aeropuerto	n.		airport
África	n.	f.	Africa
el albergue juvenil			youth hostel
la aldea	n.		village
alemán	adj.		German
Alemania	n.	f.	Germany
Asia	n.	f.	Asia
aterrizar	v.		to land, to touch down
Australia	n.	f.	Australia
australiano	adj.		Australian
Austria	n.	f.	Austria
la autopista	n.		motorway
el avión	n.		(aero)plane
el barco	n.		boat, ship
belga	adj.		Belgian
Bélgica	n.	f.	Belgium
la bicicleta	n.		bicycle, bike
el billete	n.		ticket
Brasil	n.	m.	Brazil
británico	adj.		British
broncearse	v.		to get a (sun)tan
el bus/autobús	n.		bus
el camping	n.		campsite
Canadá	n.	m.	Canada
canadiense	adj.		Canadian
cansado	adj.		tiring, weary; tedious, boring
el carretera	n.		(main) road
el chaleco salvavidas			life jacket
China	n.	f.	China
chino	adj.		Chinese
el ciclomotor	n.		moped
la ciudad	n.		town, city
el coche	n.		car
comunicar	v.		to communicate
danés	adj.		Danish
deshacer las maletas			to unpack (one's bags)
despegar	v.		to take off, to leave the ground
Dinamarca	n.	f.	Denmark
la dirección	n.		direction
Egipto	n.	m.	Egypt
entender	v.		to understand
el equipaje	n.		luggage, baggage
escocés	adj.		Scottish
Escocia	n.	f.	Scotland
España	n.	f.	Spain
español	adj.		Spanish
la estación	n.		station
los Estados Unidos			(the) United States
el este	n.		(the) east
Europa	n.	f.	Europe
la excursión	n.		excursion, outing
exótico	adj.		exotic
explorar	v.		to explore
en el extranjero			abroad
extranjero	adj.		foreign
el ferrocarril	n.		railway
francés	adj.		French
Francia	n.	f.	France
la frontera	n.		border, frontier
galés	adj.		Welsh
la gasolina	n.		petrol
la gasolinera	n.		petrol station
Grecia	n.	f.	Greece
griego	adj.		Greek
hablar español			to speak Spanish
hacer las maletas			to pack (one's bags)
Holanda	n.	f.	Holland
holandés	adj.		Dutch
el hotel	n.		hotel
húngaro	adj.		Hungarian
Hungría	n.	f.	Hungary
la India	n.		India
Inglaterra	n.	f.	England
inglés	adj.		English
Irlanda	n.	f.	Ireland
irlandés	adj.		Irish
Italia	n.	f.	Italy
italiano	adj.		Italian
Japón	n.	m.	Japan
japonés	adj.		Japanese
lejano	adj.		distant, remote, far-off
la lengua	n.		language, tongue
lento	adj.		slow
ligero	adj.		light
la maleta	n.		suitcase
el mapa	n.		map
el Mar Báltico			Baltic Sea
el Mar del Norte			North Sea
el Mar Mediterráneo			Mediterranean Sea
el Mar Negro			Black Sea
marcharse de vacaciones			to go (away) on holiday
la mochila	n.		rucksack, backpack
la moneda	n.		currency; coin
la motocicleta	n.		motorcycle, motorbike
el mundo	n.		world
el norte	n.		(the) north
Norteamérica	n.	f.	North America
norteamericano	adj.		North American
Noruega	n.	f.	Norway
noruego	adj.		Norwegian
Nueva Zelanda			New Zealand
el Océano Antártico			Antarctic Ocean
el Océano Atlántico			Atlantic Ocean
el Océano (Glacial) Ártico			Arctic Ocean
el Océano Índico			Indian Ocean
el Océano Pacífico			Pacific Ocean
el oeste	n.		(the) west
el país	n.		country
el País de Gales			Wales
los Países Bajos			(the) Netherlands
la parada de autobús			bus stop
el pasaporte	n.		passport
pesado	adj.		heavy
la playa	n.		beach; seaside
polaco	adj.		Polish
el Polo Norte			North Pole
el Polo Sur			South Pole
Polonia	n.	f.	Poland
Portugal	n.	m.	Portugal
portugués	adj.		Portuguese
el puerto	n.		port, harbour
rápido	adj.		fast, quick, rapid
la región	n.		region, district, area
el Reino Unido			(the) United Kingdom
Rusia	n.	f.	Russia
ruso	adj.		Russian
sudamericano/suramericano	adj.		South American
Sudamérica/Suramérica	n.	f.	South America
Suecia	n.	f.	Sweden
sueco	adj.		Swedish
Suiza	n.	f.	Switzerland
suizo	adj.		Swiss
el sur	n.		(the) south
la tarjeta postal			postcard
el taxi	n.		taxi
la tienda de campaña			tent
el tranvía	n.		tram
tropical	adj.		tropical
turco	adj.		Turkish
el turismo	n.		tourism
Turquía	n.	f.	Turkey
las vacaciones	n.		holiday(s)
viajar	v.		to travel
el viaje	n.		journey, voyage; tour
el visado	n.		visa
la visita	n.		visit
visitar los monumentos			to see the sights, to go sightseeing